id,transaction_id,account_address,mint_address,pre_balance,post_balance,balance_delta
5638,4027,A9eLa4Rr7Z78ovaiHQacsVsYRygtN32Pq48DhSLdhKoT,,731507060,731501269,-5791
5637,4026,3KvsoNxgn64nsuHKPBHQJsguef3DgEkP2izE49k6CSAZ,,1643614454,1643599567,-14887
5636,4025,3KvsoNxgn64nsuHKPBHQJsguef3DgEkP2izE49k6CSAZ,,1643627966,1643614454,-13512
5635,4024,3KvsoNxgn64nsuHKPBHQJsguef3DgEkP2izE49k6CSAZ,,1643647371,1643627966,-19405
5634,4023,A9eLa4Rr7Z78ovaiHQacsVsYRygtN32Pq48DhSLdhKoT,,732180919,732174857,-6062
5633,4022,3KvsoNxgn64nsuHKPBHQJsguef3DgEkP2izE49k6CSAZ,,1647290743,1647262487,-28256
5632,4021,VUUXnZKyT1Zn2Tcr217sTdXymzyJ2Xs34k28Lnqtto9,,8763600414,8763555601,-44813
5631,4020,ADuUkR4vqLUMWXxW9gh6D6L8pMSawimctcNZ5pGwDcEt,,966542,990694,24152
5630,4020,3KvsoNxgn64nsuHKPBHQJsguef3DgEkP2izE49k6CSAZ,,1664621680,1664592528,-29152
5629,4019,A9eLa4Rr7Z78ovaiHQacsVsYRygtN32Pq48DhSLdhKoT,,737014458,737008407,-6051
5628,4018,DttWaMuVvTiduZRnguLF7jNxTgiMBZ1hyAumKUiL2KRL,,1096664,1098269,1605
5627,4018,77777T2qnynHFsA63FyfY766ciBTXizavU1f5HeZXwN,,4203341513,4203334908,-6605
5626,4017,ADuUkR4vqLUMWXxW9gh6D6L8pMSawimctcNZ5pGwDcEt,,1515694,1534476,18782
5625,4017,3KvsoNxgn64nsuHKPBHQJsguef3DgEkP2izE49k6CSAZ,,1664645462,1664621680,-23782
5624,4016,3KvsoNxgn64nsuHKPBHQJsguef3DgEkP2izE49k6CSAZ,,1664666789,1664645462,-21327
5623,4015,99999ocGGdLH45WazXhY3kmLc98iSNm7bL2nTH15TwTA,,155397096,155391389,-5707
5622,4014,A9eLa4Rr7Z78ovaiHQacsVsYRygtN32Pq48DhSLdhKoT,,737020423,737014458,-5965
5621,4013,VUUXnZKyT1Zn2Tcr217sTdXymzyJ2Xs34k28Lnqtto9,,8775989669,8775909777,-79892
5620,4012,66666y3RmL6gNyttNKXNhF5awxAWbBdGSfpKuaTLrjRH,,1261124536,1261119536,-5000
5619,4011,Cw8CFyM9FkoMi7K7Crf6HNQqf4uEMzpKw6QNghXLvLkY,,2006654,2022468,15814
5618,4011,66666y3RmL6gNyttNKXNhF5awxAWbBdGSfpKuaTLrjRH,,1261145350,1261124536,-20814
5617,4010,J9b2aebAorU2WLCffN5yb2m3XtEcpta886E1RqLXHhiG,,0,1100000,1100000
5616,4010,VUUXnZKyT1Zn2Tcr217sTdXymzyJ2Xs34k28Lnqtto9,,8823984623,8822879623,-1105000
5615,4009,EBmZAFVdeALi2MKWgxDPqZkFnQKcV13EFCrVGuzCUXC,,0,1100000,1100000
5614,4009,VUUXnZKyT1Zn2Tcr217sTdXymzyJ2Xs34k28Lnqtto9,,8824001535,8822896535,-1105000
5613,4008,99999ocGGdLH45WazXhY3kmLc98iSNm7bL2nTH15TwTA,,165318839,165313121,-5718
5612,4007,A9eLa4Rr7Z78ovaiHQacsVsYRygtN32Pq48DhSLdhKoT,,775298945,775292921,-6024
5611,4006,3KvsoNxgn64nsuHKPBHQJsguef3DgEkP2izE49k6CSAZ,,1707220910,1707199850,-21060
5610,4005,3KvsoNxgn64nsuHKPBHQJsguef3DgEkP2izE49k6CSAZ,,1707242322,1707220910,-21412
5609,4004,3KvsoNxgn64nsuHKPBHQJsguef3DgEkP2izE49k6CSAZ,,1707263228,1707242322,-20906
5608,4003,99999ocGGdLH45WazXhY3kmLc98iSNm7bL2nTH15TwTA,,171843682,171837980,-5702
5607,4002,5dTQx1yz5RV7jYTjY1fLkVAYBwmNzmU388fa27c1XBE1,,0,1100000,1100000
5606,4002,VUUXnZKyT1Zn2Tcr217sTdXymzyJ2Xs34k28Lnqtto9,,8860627490,8859522490,-1105000
5605,4001,VUUXnZKyT1Zn2Tcr217sTdXymzyJ2Xs34k28Lnqtto9,,8880107176,8880077823,-29353
5604,4000,3KvsoNxgn64nsuHKPBHQJsguef3DgEkP2izE49k6CSAZ,,1775284118,1775170655,-113463
5603,3999,3KvsoNxgn64nsuHKPBHQJsguef3DgEkP2izE49k6CSAZ,,1775395554,1775284118,-111436
5602,3998,99999ocGGdLH45WazXhY3kmLc98iSNm7bL2nTH15TwTA,,176553522,176547957,-5565
5601,3997,HFqU5x63VTqvQss8hp11i4wVV8bD44PvwucfZ2bU7gRe,,1993869,2025628,31759
5600,3997,3KvsoNxgn64nsuHKPBHQJsguef3DgEkP2izE49k6CSAZ,,1775432313,1775395554,-36759
5599,3996,DfXygSm4jCyNCybVYYK6DwvWqjKee8pbDmJGcLWNDXjh,,2078120,2079268,1148
5598,3996,77777T2qnynHFsA63FyfY766ciBTXizavU1f5HeZXwN,,4210940322,4210934174,-6148
5597,3995,99999ocGGdLH45WazXhY3kmLc98iSNm7bL2nTH15TwTA,,181219619,181213717,-5902
5596,3994,99999ocGGdLH45WazXhY3kmLc98iSNm7bL2nTH15TwTA,,181225414,181219619,-5795
5595,3993,VUUXnZKyT1Zn2Tcr217sTdXymzyJ2Xs34k28Lnqtto9,,8901215874,8901205190,-10684
5594,3992,VUUXnZKyT1Zn2Tcr217sTdXymzyJ2Xs34k28Lnqtto9,,8901226561,8901215874,-10687
5593,3991,99999ocGGdLH45WazXhY3kmLc98iSNm7bL2nTH15TwTA,,181231286,181225414,-5872
5592,3990,VUUXnZKyT1Zn2Tcr217sTdXymzyJ2Xs34k28Lnqtto9,,8901237246,8901226561,-10685
5591,3989,99999ocGGdLH45WazXhY3kmLc98iSNm7bL2nTH15TwTA,,181237087,181231286,-5801
5590,3988,VUUXnZKyT1Zn2Tcr217sTdXymzyJ2Xs34k28Lnqtto9,,8901247929,8901237246,-10683
5589,3987,99999ocGGdLH45WazXhY3kmLc98iSNm7bL2nTH15TwTA,,181242787,181237087,-5700
5588,3986,VUUXnZKyT1Zn2Tcr217sTdXymzyJ2Xs34k28Lnqtto9,,8901258607,8901247929,-10678
5587,3985,VUUXnZKyT1Zn2Tcr217sTdXymzyJ2Xs34k28Lnqtto9,,8901269292,8901258607,-10685
5586,3984,VUUXnZKyT1Zn2Tcr217sTdXymzyJ2Xs34k28Lnqtto9,,8901279970,8901269292,-10678
5585,3983,VUUXnZKyT1Zn2Tcr217sTdXymzyJ2Xs34k28Lnqtto9,,8901291006,8901279970,-11036
5584,3982,99999ocGGdLH45WazXhY3kmLc98iSNm7bL2nTH15TwTA,,181248543,181242787,-5756
5583,3981,99999ocGGdLH45WazXhY3kmLc98iSNm7bL2nTH15TwTA,,181254120,181248543,-5577
5582,3980,99999ocGGdLH45WazXhY3kmLc98iSNm7bL2nTH15TwTA,,181260062,181254120,-5942
5581,3979,VUUXnZKyT1Zn2Tcr217sTdXymzyJ2Xs34k28Lnqtto9,,8901302054,8901291006,-11048
5580,3978,99999ocGGdLH45WazXhY3kmLc98iSNm7bL2nTH15TwTA,,181265909,181260062,-5847
5579,3977,2ovKxH5RqRLhDVHutbGxkcCotrvCx9UgP2HiqaAzTK2o,,0,1100000,1100000
5578,3977,VUUXnZKyT1Zn2Tcr217sTdXymzyJ2Xs34k28Lnqtto9,,8901318875,8900213875,-1105000
5577,3976,77777T2qnynHFsA63FyfY766ciBTXizavU1f5HeZXwN,,4212165719,4212160719,-5000
5576,3975,3AVi9Tg9Uo68tJfuvoKvqKNWKkC5wPdSSdeBnizKZ6jT,,952471,953704,1233
5575,3975,77777T2qnynHFsA63FyfY766ciBTXizavU1f5HeZXwN,,4212171952,4212165719,-6233
5574,3974,77777T2qnynHFsA63FyfY766ciBTXizavU1f5HeZXwN,,4212178484,4212171952,-6532
5573,3973,VUUXnZKyT1Zn2Tcr217sTdXymzyJ2Xs34k28Lnqtto9,,8901329913,8901318875,-11038
5572,3972,99999ocGGdLH45WazXhY3kmLc98iSNm7bL2nTH15TwTA,,181271521,181265909,-5612
5571,3971,HFqU5x63VTqvQss8hp11i4wVV8bD44PvwucfZ2bU7gRe,,2033686,2035316,1630
5570,3971,77777T2qnynHFsA63FyfY766ciBTXizavU1f5HeZXwN,,4212185114,4212178484,-6630
5569,3970,FpvE9rnLTParcatDGGMvzXk4cbu7i5EUbuMdJSB9o7TA,,0,1100000,1100000
5568,3970,VUUXnZKyT1Zn2Tcr217sTdXymzyJ2Xs34k28Lnqtto9,,8901346734,8900241734,-1105000
5567,3969,VUUXnZKyT1Zn2Tcr217sTdXymzyJ2Xs34k28Lnqtto9,,8901366591,8901346734,-19857
5566,3968,99999ocGGdLH45WazXhY3kmLc98iSNm7bL2nTH15TwTA,,181277513,181271521,-5992
5565,3967,77777T2qnynHFsA63FyfY766ciBTXizavU1f5HeZXwN,,4212191727,4212185114,-6613
5564,3966,VUUXnZKyT1Zn2Tcr217sTdXymzyJ2Xs34k28Lnqtto9,,8901386437,8901366591,-19846
5563,3965,VUUXnZKyT1Zn2Tcr217sTdXymzyJ2Xs34k28Lnqtto9,,8901406276,8901386437,-19839
5562,3964,VUUXnZKyT1Zn2Tcr217sTdXymzyJ2Xs34k28Lnqtto9,,8901426110,8901406276,-19834
5561,3963,99999ocGGdLH45WazXhY3kmLc98iSNm7bL2nTH15TwTA,,181283296,181277513,-5783
5560,3962,99999ocGGdLH45WazXhY3kmLc98iSNm7bL2nTH15TwTA,,181289159,181283296,-5863
5559,3961,Aj4sVu2MubU8YdLoYQPCJKqyTUN7yjJZC8EZCY7Nrj6z,,0,1100000,1100000
5558,3961,VUUXnZKyT1Zn2Tcr217sTdXymzyJ2Xs34k28Lnqtto9,,8901442133,8900337133,-1105000
5557,3960,E1dah2nZsQ5uS7cKjGitXaciThU7wL6WiVuxmkMryNb2,,0,1100000,1100000
5556,3960,VUUXnZKyT1Zn2Tcr217sTdXymzyJ2Xs34k28Lnqtto9,,8903959977,8902854977,-1105000
5555,3959,3KvsoNxgn64nsuHKPBHQJsguef3DgEkP2izE49k6CSAZ,,1803689261,1803681389,-7872
5554,3958,3KvsoNxgn64nsuHKPBHQJsguef3DgEkP2izE49k6CSAZ,,1803697464,1803689261,-8203
5553,3957,8L35xGZBhgoBe5it7nJQtXWZJwqSRVeAf9nzw8MQHsUJ,,0,1100000,1100000
5552,3957,VUUXnZKyT1Zn2Tcr217sTdXymzyJ2Xs34k28Lnqtto9,,8921655253,8920550253,-1105000
5551,3956,VUUXnZKyT1Zn2Tcr217sTdXymzyJ2Xs34k28Lnqtto9,,8921836068,8921828667,-7401
5550,3955,99999ocGGdLH45WazXhY3kmLc98iSNm7bL2nTH15TwTA,,192000043,191994338,-5705
5549,3954,99999ocGGdLH45WazXhY3kmLc98iSNm7bL2nTH15TwTA,,192947050,192941104,-5946
5548,3953,VUUXnZKyT1Zn2Tcr217sTdXymzyJ2Xs34k28Lnqtto9,,8925048284,8925040886,-7398
5547,3952,99999ocGGdLH45WazXhY3kmLc98iSNm7bL2nTH15TwTA,,192952605,192947050,-5555
5546,3951,VUUXnZKyT1Zn2Tcr217sTdXymzyJ2Xs34k28Lnqtto9,,8925055685,8925048284,-7401
5545,3950,VUUXnZKyT1Zn2Tcr217sTdXymzyJ2Xs34k28Lnqtto9,,8925063084,8925055685,-7399
5544,3949,99999ocGGdLH45WazXhY3kmLc98iSNm7bL2nTH15TwTA,,192958532,192952605,-5927
5543,3948,99999ocGGdLH45WazXhY3kmLc98iSNm7bL2nTH15TwTA,,192964370,192958532,-5838
5542,3947,VUUXnZKyT1Zn2Tcr217sTdXymzyJ2Xs34k28Lnqtto9,,8933779071,8933771674,-7397
5541,3946,99999ocGGdLH45WazXhY3kmLc98iSNm7bL2nTH15TwTA,,197641958,197636327,-5631
5540,3945,JAhHNUJq32JXDwPqvoZTvzoW51J4uqKZajHZD7Ec8Lty,,0,1100000,1100000
5539,3945,VUUXnZKyT1Zn2Tcr217sTdXymzyJ2Xs34k28Lnqtto9,,8937169309,8936064309,-1105000
5538,3944,AmJ2bbFshvusYFiHzDqg2KSQbGdfngTrb6XBmJnHwi22,,0,1100000,1100000
5537,3944,VUUXnZKyT1Zn2Tcr217sTdXymzyJ2Xs34k28Lnqtto9,,8937194458,8936089458,-1105000
5536,3943,99999ocGGdLH45WazXhY3kmLc98iSNm7bL2nTH15TwTA,,198610318,198604610,-5708
5535,3942,66666y3RmL6gNyttNKXNhF5awxAWbBdGSfpKuaTLrjRH,,1277718786,1277705202,-13584
5534,3941,VUUXnZKyT1Zn2Tcr217sTdXymzyJ2Xs34k28Lnqtto9,,8937201856,8937194458,-7398
5533,3940,99999ocGGdLH45WazXhY3kmLc98iSNm7bL2nTH15TwTA,,198616151,198610318,-5833
5532,3939,VUUXnZKyT1Zn2Tcr217sTdXymzyJ2Xs34k28Lnqtto9,,8937210193,8937201856,-8337
5531,3938,ADaUMid9yfUytqMBgopwjb2DTLSokTSzL1zt6iGPaS49,,1173902,1192476,18574
5530,3938,66666y3RmL6gNyttNKXNhF5awxAWbBdGSfpKuaTLrjRH,,1277742360,1277718786,-23574
5529,3937,3KvsoNxgn64nsuHKPBHQJsguef3DgEkP2izE49k6CSAZ,,1813491741,1813483456,-8285
5528,3936,VUUXnZKyT1Zn2Tcr217sTdXymzyJ2Xs34k28Lnqtto9,,8950290306,8950282906,-7400
5527,3935,A9eLa4Rr7Z78ovaiHQacsVsYRygtN32Pq48DhSLdhKoT,,808604339,808598494,-5845
5526,3934,3KvsoNxgn64nsuHKPBHQJsguef3DgEkP2izE49k6CSAZ,,1815907620,1815899900,-7720
5525,3933,A9eLa4Rr7Z78ovaiHQacsVsYRygtN32Pq48DhSLdhKoT,,808610276,808604339,-5937
5524,3932,3KvsoNxgn64nsuHKPBHQJsguef3DgEkP2izE49k6CSAZ,,1815915833,1815907620,-8213
5523,3931,VUUXnZKyT1Zn2Tcr217sTdXymzyJ2Xs34k28Lnqtto9,,8965033328,8965025932,-7396
5522,3930,92zpDPkQkXcz6aGJJFBf3CUHsdUYJv6dYThmzGFuMQBg,,0,1100000,1100000
5521,3930,VUUXnZKyT1Zn2Tcr217sTdXymzyJ2Xs34k28Lnqtto9,,8965219704,8964114704,-1105000
5520,3929,VUUXnZKyT1Zn2Tcr217sTdXymzyJ2Xs34k28Lnqtto9,,8965239904,8965219704,-20200
5519,3928,VUUXnZKyT1Zn2Tcr217sTdXymzyJ2Xs34k28Lnqtto9,,8965247302,8965239904,-7398
5518,3927,VUUXnZKyT1Zn2Tcr217sTdXymzyJ2Xs34k28Lnqtto9,,8978829751,8978813368,-16383
5517,3926,VUUXnZKyT1Zn2Tcr217sTdXymzyJ2Xs34k28Lnqtto9,,8978846537,8978829751,-16786
5516,3925,Dfax8hzLKNQf31vRBef12qh8hkitm8jcaoBvVaQqvVF,,0,1100000,1100000
5515,3925,VUUXnZKyT1Zn2Tcr217sTdXymzyJ2Xs34k28Lnqtto9,,8978875535,8977770535,-1105000
5514,3924,HA7VU85SLWu8v21FGttxrKiL2fjFWsXCAzTZHV69zMho,,0,1100000,1100000
5513,3924,VUUXnZKyT1Zn2Tcr217sTdXymzyJ2Xs34k28Lnqtto9,,8978904533,8977799533,-1105000
5512,3923,VUUXnZKyT1Zn2Tcr217sTdXymzyJ2Xs34k28Lnqtto9,,8978921308,8978904533,-16775
5511,3922,VUUXnZKyT1Zn2Tcr217sTdXymzyJ2Xs34k28Lnqtto9,,8978938089,8978921308,-16781
5510,3921,VUUXnZKyT1Zn2Tcr217sTdXymzyJ2Xs34k28Lnqtto9,,8978954877,8978938089,-16788
5509,3920,VUUXnZKyT1Zn2Tcr217sTdXymzyJ2Xs34k28Lnqtto9,,8978971656,8978954877,-16779
5508,3919,VUUXnZKyT1Zn2Tcr217sTdXymzyJ2Xs34k28Lnqtto9,,8978988439,8978971656,-16783
5507,3918,VUUXnZKyT1Zn2Tcr217sTdXymzyJ2Xs34k28Lnqtto9,,8979005225,8978988439,-16786
5506,3917,VUUXnZKyT1Zn2Tcr217sTdXymzyJ2Xs34k28Lnqtto9,,8979021996,8979005225,-16771
5505,3916,VUUXnZKyT1Zn2Tcr217sTdXymzyJ2Xs34k28Lnqtto9,,8979038782,8979021996,-16786
5504,3915,VUUXnZKyT1Zn2Tcr217sTdXymzyJ2Xs34k28Lnqtto9,,8979055554,8979038782,-16772
5503,3914,HgGR8yxgs95PVWCyPZU51aHTSNiocipXB7Afsa28A63S,,0,1100000,1100000
5502,3914,VUUXnZKyT1Zn2Tcr217sTdXymzyJ2Xs34k28Lnqtto9,,8979084552,8977979552,-1105000
5501,3913,BFYWyNHRtxMBqN8KnBVfhMKPoF1zpn7KbKzATQtQj4PQ,,0,1100000,1100000
5500,3913,VUUXnZKyT1Zn2Tcr217sTdXymzyJ2Xs34k28Lnqtto9,,8979113550,8978008550,-1105000
5499,3912,VUUXnZKyT1Zn2Tcr217sTdXymzyJ2Xs34k28Lnqtto9,,8979130324,8979113550,-16774
5498,3911,VUUXnZKyT1Zn2Tcr217sTdXymzyJ2Xs34k28Lnqtto9,,8979147112,8979130324,-16788
5497,3910,VUUXnZKyT1Zn2Tcr217sTdXymzyJ2Xs34k28Lnqtto9,,8979154509,8979147112,-7397
5496,3909,VUUXnZKyT1Zn2Tcr217sTdXymzyJ2Xs34k28Lnqtto9,,8979171302,8979154509,-16793
5495,3908,2KVJZjhxQKcJJjcP13C2QuEd5t5t8KyGMWH9YxCZMscH,,0,1100000,1100000
5494,3908,VUUXnZKyT1Zn2Tcr217sTdXymzyJ2Xs34k28Lnqtto9,,8979200300,8978095300,-1105000
5493,3907,VUUXnZKyT1Zn2Tcr217sTdXymzyJ2Xs34k28Lnqtto9,,8979207697,8979200300,-7397
5492,3906,VUUXnZKyT1Zn2Tcr217sTdXymzyJ2Xs34k28Lnqtto9,,8979215093,8979207697,-7396
5491,3905,VUUXnZKyT1Zn2Tcr217sTdXymzyJ2Xs34k28Lnqtto9,,8979222489,8979215093,-7396
5490,3904,VUUXnZKyT1Zn2Tcr217sTdXymzyJ2Xs34k28Lnqtto9,,8979229886,8979222489,-7397
5489,3903,BjZRKTKRicozo8ixDJeE43JRRpAWspb8AfKtpWRaeZzc,,0,1100000,1100000
5488,3903,VUUXnZKyT1Zn2Tcr217sTdXymzyJ2Xs34k28Lnqtto9,,8979258884,8978153884,-1105000
5487,3902,VUUXnZKyT1Zn2Tcr217sTdXymzyJ2Xs34k28Lnqtto9,,8979266281,8979258884,-7397
5486,3901,VUUXnZKyT1Zn2Tcr217sTdXymzyJ2Xs34k28Lnqtto9,,8979273678,8979266281,-7397
5485,3900,VUUXnZKyT1Zn2Tcr217sTdXymzyJ2Xs34k28Lnqtto9,,8979281078,8979273678,-7400
5484,3899,VUUXnZKyT1Zn2Tcr217sTdXymzyJ2Xs34k28Lnqtto9,,8979288476,8979281078,-7398
5483,3898,VUUXnZKyT1Zn2Tcr217sTdXymzyJ2Xs34k28Lnqtto9,,8979295875,8979288476,-7399
5482,3897,VUUXnZKyT1Zn2Tcr217sTdXymzyJ2Xs34k28Lnqtto9,,8979303274,8979295875,-7399
5481,3896,HKrNMeWqhSZGV7v1EhiXAVsfNjrMSkSBywwaRawUYffM,,0,1100000,1100000
5480,3896,VUUXnZKyT1Zn2Tcr217sTdXymzyJ2Xs34k28Lnqtto9,,8979331037,8978226037,-1105000
5479,3895,VUUXnZKyT1Zn2Tcr217sTdXymzyJ2Xs34k28Lnqtto9,,8979338899,8979331037,-7862
5478,3894,VUUXnZKyT1Zn2Tcr217sTdXymzyJ2Xs34k28Lnqtto9,,8979346299,8979338899,-7400
5477,3893,VUUXnZKyT1Zn2Tcr217sTdXymzyJ2Xs34k28Lnqtto9,,8979353696,8979346299,-7397
5476,3892,TuEfGhqovsAq1LxDfeaTDvgYKpC1qYodZbtN2c953Jk,,0,1100000,1100000
5475,3892,VUUXnZKyT1Zn2Tcr217sTdXymzyJ2Xs34k28Lnqtto9,,8979381955,8978276955,-1105000
5474,3891,5r8CHoP8WY3zmXDmetK1srEv61r4oE3a9hZUSTnRQTbe,,0,1100000,1100000
5473,3891,VUUXnZKyT1Zn2Tcr217sTdXymzyJ2Xs34k28Lnqtto9,,8979410214,8978305214,-1105000
5472,3890,VUUXnZKyT1Zn2Tcr217sTdXymzyJ2Xs34k28Lnqtto9,,8979417612,8979410214,-7398
5471,3889,VUUXnZKyT1Zn2Tcr217sTdXymzyJ2Xs34k28Lnqtto9,,8979425012,8979417612,-7400
5470,3888,VUUXnZKyT1Zn2Tcr217sTdXymzyJ2Xs34k28Lnqtto9,,8979432411,8979425012,-7399
5469,3887,VUUXnZKyT1Zn2Tcr217sTdXymzyJ2Xs34k28Lnqtto9,,8979440705,8979432411,-8294
5468,3886,VUUXnZKyT1Zn2Tcr217sTdXymzyJ2Xs34k28Lnqtto9,,8979448996,8979440705,-8291
5467,3885,VUUXnZKyT1Zn2Tcr217sTdXymzyJ2Xs34k28Lnqtto9,,8979457287,8979448996,-8291
5466,3884,VUUXnZKyT1Zn2Tcr217sTdXymzyJ2Xs34k28Lnqtto9,,8979465577,8979457287,-8290
5465,3883,66666y3RmL6gNyttNKXNhF5awxAWbBdGSfpKuaTLrjRH,,1283074111,1283062215,-11896
5464,3882,G3JgHrojdqp9ZFZchyfnXFToFEVD2HeACYua5oRDEAKB,,0,1100000,1100000
5463,3882,VUUXnZKyT1Zn2Tcr217sTdXymzyJ2Xs34k28Lnqtto9,,8980999947,8979894947,-1105000
5462,3881,EAzc3QpPJiQkKJfcsmJMgE6oy8dtKDx4RU7o7Ps8UERP,,0,1100000,1100000
5461,3881,VUUXnZKyT1Zn2Tcr217sTdXymzyJ2Xs34k28Lnqtto9,,8982038640,8980933640,-1105000
5460,3880,FenuEoWEdR1txSXauCPXMnkYR2ZcaLy9f92W2WZoqXgg,,0,1100000,1100000
5459,3880,VUUXnZKyT1Zn2Tcr217sTdXymzyJ2Xs34k28Lnqtto9,,8984199756,8983094756,-1105000
5458,3879,z8TdcU6SkQwNuktvcsnLBzwvyaUCuiAbiZxhnVYE2yR,,0,1100000,1100000
5457,3879,VUUXnZKyT1Zn2Tcr217sTdXymzyJ2Xs34k28Lnqtto9,,8984215552,8983110552,-1105000
5456,3878,DQzNFECDRfLHCfdE9tVqWP7qZkwzNy4VTAsDdqqpT3BT,,0,1100000,1100000
5455,3878,VUUXnZKyT1Zn2Tcr217sTdXymzyJ2Xs34k28Lnqtto9,,8988023582,8986918582,-1105000
5454,3877,VUUXnZKyT1Zn2Tcr217sTdXymzyJ2Xs34k28Lnqtto9,,8996807014,8996799615,-7399
5453,3876,VUUXnZKyT1Zn2Tcr217sTdXymzyJ2Xs34k28Lnqtto9,,9002135171,9002127774,-7397
5452,3875,VUUXnZKyT1Zn2Tcr217sTdXymzyJ2Xs34k28Lnqtto9,,9001898035,9001890635,-7400
5451,3874,VUUXnZKyT1Zn2Tcr217sTdXymzyJ2Xs34k28Lnqtto9,,9002142572,9002135171,-7401
5450,3873,VUUXnZKyT1Zn2Tcr217sTdXymzyJ2Xs34k28Lnqtto9,,9002149969,9002142572,-7397
5449,3872,VUUXnZKyT1Zn2Tcr217sTdXymzyJ2Xs34k28Lnqtto9,,9017595996,9017588597,-7399
5448,3871,VUUXnZKyT1Zn2Tcr217sTdXymzyJ2Xs34k28Lnqtto9,,9017604157,9017595996,-8161
5447,3870,VUUXnZKyT1Zn2Tcr217sTdXymzyJ2Xs34k28Lnqtto9,,9017611556,9017604157,-7399
5446,3869,VUUXnZKyT1Zn2Tcr217sTdXymzyJ2Xs34k28Lnqtto9,,9017618954,9017611556,-7398
5445,3868,3Hf2iC8EjHGPDfUdbVFuNvdLf8tjEUyqA5R2GE62avJJ,,0,1100000,1100000
5444,3868,VUUXnZKyT1Zn2Tcr217sTdXymzyJ2Xs34k28Lnqtto9,,9017634858,9016529858,-1105000
5443,3867,VUUXnZKyT1Zn2Tcr217sTdXymzyJ2Xs34k28Lnqtto9,,9017642257,9017634858,-7399
5442,3866,VUUXnZKyT1Zn2Tcr217sTdXymzyJ2Xs34k28Lnqtto9,,9017649654,9017642257,-7397
5441,3865,VUUXnZKyT1Zn2Tcr217sTdXymzyJ2Xs34k28Lnqtto9,,9017657054,9017649654,-7400
5440,3864,VUUXnZKyT1Zn2Tcr217sTdXymzyJ2Xs34k28Lnqtto9,,9017664455,9017657054,-7401
5439,3863,VUUXnZKyT1Zn2Tcr217sTdXymzyJ2Xs34k28Lnqtto9,,9017671854,9017664455,-7399
5438,3862,VUUXnZKyT1Zn2Tcr217sTdXymzyJ2Xs34k28Lnqtto9,,9017679253,9017671854,-7399
5437,3861,VUUXnZKyT1Zn2Tcr217sTdXymzyJ2Xs34k28Lnqtto9,,9017686652,9017679253,-7399
5436,3860,VUUXnZKyT1Zn2Tcr217sTdXymzyJ2Xs34k28Lnqtto9,,9017694051,9017686652,-7399
5435,3859,VUUXnZKyT1Zn2Tcr217sTdXymzyJ2Xs34k28Lnqtto9,,9017701449,9017694051,-7398
5434,3858,VUUXnZKyT1Zn2Tcr217sTdXymzyJ2Xs34k28Lnqtto9,,9017708846,9017701449,-7397
5433,3857,VUUXnZKyT1Zn2Tcr217sTdXymzyJ2Xs34k28Lnqtto9,,9017716244,9017708846,-7398
5432,3856,VUUXnZKyT1Zn2Tcr217sTdXymzyJ2Xs34k28Lnqtto9,,9017723644,9017716244,-7400
5431,3855,VUUXnZKyT1Zn2Tcr217sTdXymzyJ2Xs34k28Lnqtto9,,9017731042,9017723644,-7398
5430,3854,VUUXnZKyT1Zn2Tcr217sTdXymzyJ2Xs34k28Lnqtto9,,9017738439,9017731042,-7397
5429,3853,3vYWYLnaxQjSvT3Ne75SSjt9GU6HGFmPm1veZaCwTVnx,,0,1100000,1100000
5428,3853,VUUXnZKyT1Zn2Tcr217sTdXymzyJ2Xs34k28Lnqtto9,,9017753552,9016648552,-1105000
5427,3852,VUUXnZKyT1Zn2Tcr217sTdXymzyJ2Xs34k28Lnqtto9,,8965057590,8965050193,-7397
5426,3851,VUUXnZKyT1Zn2Tcr217sTdXymzyJ2Xs34k28Lnqtto9,,8963485669,8963478270,-7399
5425,3850,VUUXnZKyT1Zn2Tcr217sTdXymzyJ2Xs34k28Lnqtto9,,8965064987,8965057590,-7397
5424,3849,VUUXnZKyT1Zn2Tcr217sTdXymzyJ2Xs34k28Lnqtto9,,8963493065,8963485669,-7396
5423,3848,GHoPA17XR9Rwqna6Umf8KCiGMWhqjH9obpnYQ6kxRiqs,,0,1100000,1100000
5422,3848,VUUXnZKyT1Zn2Tcr217sTdXymzyJ2Xs34k28Lnqtto9,,8965080726,8963975726,-1105000
5421,3847,7e9gNynRVxEMAUmeTxZ8gdVGcKKz76St7Nr8Sn1SFy7E,,0,1100000,1100000
5420,3847,VUUXnZKyT1Zn2Tcr217sTdXymzyJ2Xs34k28Lnqtto9,,8963508150,8962403150,-1105000
5419,3846,VUUXnZKyT1Zn2Tcr217sTdXymzyJ2Xs34k28Lnqtto9,,8965088126,8965080726,-7400
5418,3845,VUUXnZKyT1Zn2Tcr217sTdXymzyJ2Xs34k28Lnqtto9,,8963515550,8963508150,-7400
5417,3844,VUUXnZKyT1Zn2Tcr217sTdXymzyJ2Xs34k28Lnqtto9,,8965095523,8965088126,-7397
5416,3842,VUUXnZKyT1Zn2Tcr217sTdXymzyJ2Xs34k28Lnqtto9,,8963522947,8963515550,-7397
5415,3843,VUUXnZKyT1Zn2Tcr217sTdXymzyJ2Xs34k28Lnqtto9,,8965102924,8965095523,-7401
5414,3841,VUUXnZKyT1Zn2Tcr217sTdXymzyJ2Xs34k28Lnqtto9,,8965110320,8965102924,-7396
5413,3840,VUUXnZKyT1Zn2Tcr217sTdXymzyJ2Xs34k28Lnqtto9,,8963530344,8963522947,-7397
5412,3839,VUUXnZKyT1Zn2Tcr217sTdXymzyJ2Xs34k28Lnqtto9,,8965117718,8965110320,-7398
5411,3838,VUUXnZKyT1Zn2Tcr217sTdXymzyJ2Xs34k28Lnqtto9,,8963642783,8963530344,-112439
5410,3837,VUUXnZKyT1Zn2Tcr217sTdXymzyJ2Xs34k28Lnqtto9,,8965125267,8965117718,-7549
5409,3836,VUUXnZKyT1Zn2Tcr217sTdXymzyJ2Xs34k28Lnqtto9,,8963650181,8963642783,-7398
5408,3835,VUUXnZKyT1Zn2Tcr217sTdXymzyJ2Xs34k28Lnqtto9,,8965132815,8965125267,-7548
5407,3834,VUUXnZKyT1Zn2Tcr217sTdXymzyJ2Xs34k28Lnqtto9,,8963762457,8963650181,-112276
5406,3833,AoiGTtSnkDh3YR3zTrS7Tw17C4xPbbLg9oDtXVVbsxdr,,0,1100000,1100000
5405,3832,F9EtmXfB9pV43zKeHhoCreAHwgmsAeMcDjptigSVRTXX,,0,1100000,1100000
5404,3833,VUUXnZKyT1Zn2Tcr217sTdXymzyJ2Xs34k28Lnqtto9,,8965149600,8964044600,-1105000
5403,3832,VUUXnZKyT1Zn2Tcr217sTdXymzyJ2Xs34k28Lnqtto9,,8963778632,8962673632,-1105000
5402,3831,VUUXnZKyT1Zn2Tcr217sTdXymzyJ2Xs34k28Lnqtto9,,8965157151,8965149600,-7551
5401,3830,VUUXnZKyT1Zn2Tcr217sTdXymzyJ2Xs34k28Lnqtto9,,8963786689,8963778632,-8057
5400,3829,VUUXnZKyT1Zn2Tcr217sTdXymzyJ2Xs34k28Lnqtto9,,8965164699,8965157151,-7548
5399,3828,3AbYYgTKK8SZ3w9N4iH3v8bQ3Zajq4nuHyRRNmL9k5Wh,,0,1100000,1100000
5398,3828,VUUXnZKyT1Zn2Tcr217sTdXymzyJ2Xs34k28Lnqtto9,,8963802428,8962697428,-1105000
5397,3827,VUUXnZKyT1Zn2Tcr217sTdXymzyJ2Xs34k28Lnqtto9,,8965172249,8965164699,-7550
5396,3826,VUUXnZKyT1Zn2Tcr217sTdXymzyJ2Xs34k28Lnqtto9,,8963809827,8963802428,-7399
5395,3825,VUUXnZKyT1Zn2Tcr217sTdXymzyJ2Xs34k28Lnqtto9,,8963817885,8963809827,-8058
5394,3824,D1FuXhQ7hMDYexmtpKydgGfRrdx3SaQdrgqds5X6mR8p,,0,1100000,1100000
5393,3824,VUUXnZKyT1Zn2Tcr217sTdXymzyJ2Xs34k28Lnqtto9,,8965189034,8964084034,-1105000
5392,3823,VUUXnZKyT1Zn2Tcr217sTdXymzyJ2Xs34k28Lnqtto9,,8963825943,8963817885,-8058
5391,3822,VUUXnZKyT1Zn2Tcr217sTdXymzyJ2Xs34k28Lnqtto9,,8965196431,8965189034,-7397
5390,3821,VUUXnZKyT1Zn2Tcr217sTdXymzyJ2Xs34k28Lnqtto9,,8963833996,8963825943,-8053
5389,3820,VUUXnZKyT1Zn2Tcr217sTdXymzyJ2Xs34k28Lnqtto9,,8965203828,8965196431,-7397
5388,3819,VUUXnZKyT1Zn2Tcr217sTdXymzyJ2Xs34k28Lnqtto9,,8965211228,8965203828,-7400
5387,3818,9kbgvN1DERbx9x9KEhsFsLbeME3ERWyZUaWHLqLbxoQD,,0,1100000,1100000
5386,3818,VUUXnZKyT1Zn2Tcr217sTdXymzyJ2Xs34k28Lnqtto9,,8965226482,8964121482,-1105000
5385,3817,VUUXnZKyT1Zn2Tcr217sTdXymzyJ2Xs34k28Lnqtto9,,8965233879,8965226482,-7397
5384,3816,VUUXnZKyT1Zn2Tcr217sTdXymzyJ2Xs34k28Lnqtto9,,8965241276,8965233879,-7397
5383,3815,VUUXnZKyT1Zn2Tcr217sTdXymzyJ2Xs34k28Lnqtto9,,8965248673,8965241276,-7397
5382,3814,VUUXnZKyT1Zn2Tcr217sTdXymzyJ2Xs34k28Lnqtto9,,8965256072,8965248673,-7399
5381,3813,VUUXnZKyT1Zn2Tcr217sTdXymzyJ2Xs34k28Lnqtto9,,8965263469,8965256072,-7397
5380,3812,VUUXnZKyT1Zn2Tcr217sTdXymzyJ2Xs34k28Lnqtto9,,8965270868,8965263469,-7399
5379,3811,BFx1n4dyQoJmB6a2sciKnkoUuy9gJaVWYvkUu2CswbDQ,,0,1100000,1100000
5378,3811,VUUXnZKyT1Zn2Tcr217sTdXymzyJ2Xs34k28Lnqtto9,,8965286230,8964181230,-1105000
5377,3810,D4LviBhPP6CAMNdgoteNvYJDsi8yvnguNURCHjgwdG77,,0,1100000,1100000
5376,3810,VUUXnZKyT1Zn2Tcr217sTdXymzyJ2Xs34k28Lnqtto9,,8965301592,8964196592,-1105000
5375,3809,VUUXnZKyT1Zn2Tcr217sTdXymzyJ2Xs34k28Lnqtto9,,8965308992,8965301592,-7400
5374,3808,BYt8RgJeHePYVpcpUuEoQRyYpbpMmzyUxN4rAeBkEs8E,,0,1100000,1100000
5373,3808,VUUXnZKyT1Zn2Tcr217sTdXymzyJ2Xs34k28Lnqtto9,,8969209923,8968104923,-1105000
5372,3807,VUUXnZKyT1Zn2Tcr217sTdXymzyJ2Xs34k28Lnqtto9,,8969218085,8969209923,-8162
5371,3806,8UHBn1dLy367CgujP5qukxaASzbzJp2FrorYtHAr1ioC,,0,1100000,1100000
5370,3806,VUUXnZKyT1Zn2Tcr217sTdXymzyJ2Xs34k28Lnqtto9,,8982946142,8981841142,-1105000
5369,3805,E4Z9U8FRan1NMaFsSJ9DbazeD5tXmP21Ao7NXuEJ88ee,,0,1100000,1100000
5368,3805,VUUXnZKyT1Zn2Tcr217sTdXymzyJ2Xs34k28Lnqtto9,,8982962676,8981857676,-1105000
5367,3804,H1tJj5cR463fvuPrb7nADnHHY6im95ZRorj8WPGaao8G,,0,1100000,1100000
5366,3804,VUUXnZKyT1Zn2Tcr217sTdXymzyJ2Xs34k28Lnqtto9,,8982979210,8981874210,-1105000
5365,3803,CMFioCSFVGTVUA8rfHYWiBcXKgrz35aaK26CnqUmENeu,,0,1100000,1100000
5364,3803,VUUXnZKyT1Zn2Tcr217sTdXymzyJ2Xs34k28Lnqtto9,,8982994391,8981889391,-1105000
5363,3802,6Y2dxZdfRz1F339faxryJswabZgqWKvGDKZkJTPqWwtn,,0,1100000,1100000
5362,3802,VUUXnZKyT1Zn2Tcr217sTdXymzyJ2Xs34k28Lnqtto9,,8983010095,8981905095,-1105000
5361,3801,2RuH9eE7GPtPYVYxbpZkN1QEymyQSSCVhKy7PJCouybM,,0,1100000,1100000
5360,3801,VUUXnZKyT1Zn2Tcr217sTdXymzyJ2Xs34k28Lnqtto9,,8986985079,8985880079,-1105000
5359,3800,6YVvh2oixmAKhLNWg5XMC5sn1UFFGdn7iayDgtxvzi3k,,0,1100000,1100000
5358,3800,VUUXnZKyT1Zn2Tcr217sTdXymzyJ2Xs34k28Lnqtto9,,8987000783,8985895783,-1105000
5357,3799,V4L6AWfGNQAeWDZSKgd4EGULAscMLkk3WYn8tLcM2Am,,0,1100000,1100000
5356,3799,VUUXnZKyT1Zn2Tcr217sTdXymzyJ2Xs34k28Lnqtto9,,8987016487,8985911487,-1105000
5355,3798,E16Zo3YmMntJNNvnGAQxu8x2Gvx9oEw5kFMcagUxsGPd,,0,1100000,1100000
5354,3798,VUUXnZKyT1Zn2Tcr217sTdXymzyJ2Xs34k28Lnqtto9,,8987032838,8985927838,-1105000
5353,3797,9NtdPqhVpyfyuB7Qsr67PFe9fQ9QckQugCFqaAHyv75P,,0,1100000,1100000
5352,3797,VUUXnZKyT1Zn2Tcr217sTdXymzyJ2Xs34k28Lnqtto9,,8987049189,8985944189,-1105000
5351,3796,8Ao98vWjWVEXjeGpQqcA4zHsBLHjaEmce2eGhwQGwZVw,,0,1100000,1100000
5350,3796,VUUXnZKyT1Zn2Tcr217sTdXymzyJ2Xs34k28Lnqtto9,,8994027703,8992922703,-1105000
5349,3795,Jzjxm4Lw3bTJRspEtYJaHLrktk3X6FPKpnSGaMkR3MP,,0,1100000,1100000
5348,3795,VUUXnZKyT1Zn2Tcr217sTdXymzyJ2Xs34k28Lnqtto9,,8995190657,8994085657,-1105000
5347,3794,ED2zzULwDbxGQdUcEsYKiZFeNFxDiZsqD9AXC2eKFaaF,,0,1100000,1100000
5346,3794,VUUXnZKyT1Zn2Tcr217sTdXymzyJ2Xs34k28Lnqtto9,,8995207427,8994102427,-1105000
5345,3793,2uFLnAsiZMjWKgW7oYXjNcp3ZiESDMAariJjGnXUsV2T,,0,1100000,1100000
5344,3793,VUUXnZKyT1Zn2Tcr217sTdXymzyJ2Xs34k28Lnqtto9,,8995224197,8994119197,-1105000
5343,3792,4bB2ApHvncQPgoydoKTGdB7yt9bEsQCsRYW5uXwQ9vju,,0,1100000,1100000
5342,3792,VUUXnZKyT1Zn2Tcr217sTdXymzyJ2Xs34k28Lnqtto9,,8995241129,8994136129,-1105000
5341,3791,VUUXnZKyT1Zn2Tcr217sTdXymzyJ2Xs34k28Lnqtto9,,9005178391,9005170123,-8268
5340,3790,VUUXnZKyT1Zn2Tcr217sTdXymzyJ2Xs34k28Lnqtto9,,9005186656,9005178391,-8265
5339,3789,VUUXnZKyT1Zn2Tcr217sTdXymzyJ2Xs34k28Lnqtto9,,8995597779,8995485384,-112395
5338,3788,VUUXnZKyT1Zn2Tcr217sTdXymzyJ2Xs34k28Lnqtto9,,8995710223,8995597779,-112444
5337,3787,J2uQEXqminJ5kaGinNs7DgnSxcLrjDmLDkgd6z4e1Gu6,,0,1100000,1100000
5336,3787,VUUXnZKyT1Zn2Tcr217sTdXymzyJ2Xs34k28Lnqtto9,,8995726753,8994621753,-1105000
5335,3786,VUUXnZKyT1Zn2Tcr217sTdXymzyJ2Xs34k28Lnqtto9,,8995839182,8995726753,-112429
5334,3785,VUUXnZKyT1Zn2Tcr217sTdXymzyJ2Xs34k28Lnqtto9,,8995951573,8995839182,-112391
5333,3784,FMxoEL1gJe73Wq8zeym7RwZm2BVUTsTD6tWcKf3jTffZ,,0,1100000,1100000
5332,3784,VUUXnZKyT1Zn2Tcr217sTdXymzyJ2Xs34k28Lnqtto9,,8995968103,8994863103,-1105000
5331,3783,ywQ3qELkfEyfAtSFq7ZDkgepNZopW7CcrVfkMNk7eZZ,,0,1100000,1100000
5330,3783,VUUXnZKyT1Zn2Tcr217sTdXymzyJ2Xs34k28Lnqtto9,,9005210882,9004105882,-1105000
5329,3782,VUUXnZKyT1Zn2Tcr217sTdXymzyJ2Xs34k28Lnqtto9,,9005218282,9005210882,-7400
5328,3781,VUUXnZKyT1Zn2Tcr217sTdXymzyJ2Xs34k28Lnqtto9,,9005225682,9005218282,-7400
5327,3780,8Vv8m1r8hphNecCJz2TVFVwVESqXSzo6Hu3ipFeSeWfG,,0,1100000,1100000
5326,3780,VUUXnZKyT1Zn2Tcr217sTdXymzyJ2Xs34k28Lnqtto9,,9006822279,9005717279,-1105000
5325,3779,VUUXnZKyT1Zn2Tcr217sTdXymzyJ2Xs34k28Lnqtto9,,9006829676,9006822279,-7397
5324,3778,VUUXnZKyT1Zn2Tcr217sTdXymzyJ2Xs34k28Lnqtto9,,9006844596,9006837077,-7519
5323,3777,VUUXnZKyT1Zn2Tcr217sTdXymzyJ2Xs34k28Lnqtto9,,9006852115,9006844596,-7519
5322,3776,B9UAZFNbMbEYKBXzvgwrFf6K7itg1FwWuf5HL98UvQWy,,0,1100000,1100000
5321,3776,VUUXnZKyT1Zn2Tcr217sTdXymzyJ2Xs34k28Lnqtto9,,9006875840,9005770840,-1105000
5320,3775,VUUXnZKyT1Zn2Tcr217sTdXymzyJ2Xs34k28Lnqtto9,,9006883359,9006875840,-7519
5319,3774,VUUXnZKyT1Zn2Tcr217sTdXymzyJ2Xs34k28Lnqtto9,,9006890877,9006883359,-7518
5318,3773,VUUXnZKyT1Zn2Tcr217sTdXymzyJ2Xs34k28Lnqtto9,,9006898276,9006890877,-7399
5317,3772,VUUXnZKyT1Zn2Tcr217sTdXymzyJ2Xs34k28Lnqtto9,,9006905798,9006898276,-7522
5316,3771,VUUXnZKyT1Zn2Tcr217sTdXymzyJ2Xs34k28Lnqtto9,,9006913316,9006905798,-7518
5315,3770,BbwWmUtea4vjdFtfsg25dxy9mnLSoqMDGd1FpT7yC45H,,0,1100000,1100000
5314,3770,VUUXnZKyT1Zn2Tcr217sTdXymzyJ2Xs34k28Lnqtto9,,9006929522,9005824522,-1105000
5313,3769,VUUXnZKyT1Zn2Tcr217sTdXymzyJ2Xs34k28Lnqtto9,,9013735610,9013717753,-17857
5312,3767,DQqZitVJ4Z9F34XZDv5b6aAuBKddUoEQ3ytKS6criSs7,,0,1100000,1100000
5311,3767,VUUXnZKyT1Zn2Tcr217sTdXymzyJ2Xs34k28Lnqtto9,,9013751318,9012646318,-1105000
5310,3764,LZ5bXFKE8h4Dh2v9GeXg89dmifjBhQS44L8KoNozeEc,,0,1100000,1100000
5309,3764,VUUXnZKyT1Zn2Tcr217sTdXymzyJ2Xs34k28Lnqtto9,,9013767026,9012662026,-1105000
5308,3762,DKEGAdtvX7iHyv1PadeQsynNHgUJ97xmKY7rF7H1SrzJ,,0,1100000,1100000
5307,3762,VUUXnZKyT1Zn2Tcr217sTdXymzyJ2Xs34k28Lnqtto9,,9013782838,9012677838,-1105000
5306,3760,HPiwf8igNNzkCcoZxLeoenLkbpryRCgQbzZM5BqgQL9a,,0,1100000,1100000
5305,3760,VUUXnZKyT1Zn2Tcr217sTdXymzyJ2Xs34k28Lnqtto9,,9013799467,9012694467,-1105000
5304,3759,FX3c4ANrSCdT8tdNAyVGJ77MU4dCVnKBWAT436uisYxe,,0,1100000,1100000
5303,3759,VUUXnZKyT1Zn2Tcr217sTdXymzyJ2Xs34k28Lnqtto9,,9013814944,9012709944,-1105000
5302,3757,Avdh3P9NFvKEGGqDfK67idSKdBgN75RUZXmhWP9wz5fD,,0,1100000,1100000
5301,3757,VUUXnZKyT1Zn2Tcr217sTdXymzyJ2Xs34k28Lnqtto9,,9013831666,9012726666,-1105000
5300,3755,H7xaBarg1Pn3VEU8a4AVgiSHfVMsvvvnBR9eHRLsoCjA,,0,1100000,1100000
5299,3755,VUUXnZKyT1Zn2Tcr217sTdXymzyJ2Xs34k28Lnqtto9,,9013848388,9012743388,-1105000
5298,3753,9jRavZUZfNQeVcuMK1xbm7wv3zVSDRYcxEurRYdcERwP,,0,1100000,1100000
5297,3753,VUUXnZKyT1Zn2Tcr217sTdXymzyJ2Xs34k28Lnqtto9,,9013864024,9012759024,-1105000
5296,3752,VUUXnZKyT1Zn2Tcr217sTdXymzyJ2Xs34k28Lnqtto9,,9020209637,9020202240,-7397
5295,3751,VUUXnZKyT1Zn2Tcr217sTdXymzyJ2Xs34k28Lnqtto9,,9020225173,9020209637,-15536
5294,3750,9D8Ej8YGtTqq6kL7w8QCafW3AjBR4Wwco7KNfHgkWvLq,,0,1100000,1100000
5293,3750,VUUXnZKyT1Zn2Tcr217sTdXymzyJ2Xs34k28Lnqtto9,,9020240690,9019135690,-1105000
5292,3749,66666y3RmL6gNyttNKXNhF5awxAWbBdGSfpKuaTLrjRH,,1295211527,1295195257,-16270
5291,3748,VUUXnZKyT1Zn2Tcr217sTdXymzyJ2Xs34k28Lnqtto9,,9020248089,9020240690,-7399
5290,3747,66666y3RmL6gNyttNKXNhF5awxAWbBdGSfpKuaTLrjRH,,1295222373,1295211527,-10846
5289,3746,VUUXnZKyT1Zn2Tcr217sTdXymzyJ2Xs34k28Lnqtto9,,9020255488,9020248089,-7399
5288,3745,VUUXnZKyT1Zn2Tcr217sTdXymzyJ2Xs34k28Lnqtto9,,9020262884,9020255488,-7396
5287,3744,FhiPmrVFHGoqmTvvfYFPBxWDQJizxphzYVDjkbtUFTTf,,0,1100000,1100000
5286,3744,VUUXnZKyT1Zn2Tcr217sTdXymzyJ2Xs34k28Lnqtto9,,9020279347,9019174347,-1105000
5285,3743,HFqU5x63VTqvQss8hp11i4wVV8bD44PvwucfZ2bU7gRe,,2617816,2635863,18047
5284,3743,66666y3RmL6gNyttNKXNhF5awxAWbBdGSfpKuaTLrjRH,,1295245420,1295222373,-23047
5283,3742,VUUXnZKyT1Zn2Tcr217sTdXymzyJ2Xs34k28Lnqtto9,,9020391732,9020279347,-112385
5282,3741,VUUXnZKyT1Zn2Tcr217sTdXymzyJ2Xs34k28Lnqtto9,,9020504188,9020391732,-112456
5281,3740,VUUXnZKyT1Zn2Tcr217sTdXymzyJ2Xs34k28Lnqtto9,,9020511584,9020504188,-7396
5280,3739,VUUXnZKyT1Zn2Tcr217sTdXymzyJ2Xs34k28Lnqtto9,,9020519330,9020511584,-7746
5279,3738,VUUXnZKyT1Zn2Tcr217sTdXymzyJ2Xs34k28Lnqtto9,,9020527076,9020519330,-7746
5278,3737,VUUXnZKyT1Zn2Tcr217sTdXymzyJ2Xs34k28Lnqtto9,,9028450818,9028444620,-6198
5277,3736,Cx2sXbXVhxrLyh8u1zkj3iNiek6SJQ1veYooKW7V8fCz,,0,1100000,1100000
5276,3736,VUUXnZKyT1Zn2Tcr217sTdXymzyJ2Xs34k28Lnqtto9,,9026900294,9025795294,-1105000
5275,3735,E6Wagd9eL9vMfSpzVoQR7npcgWERgWmgrwUrnFZs6CHC,,0,1100000,1100000
5274,3735,VUUXnZKyT1Zn2Tcr217sTdXymzyJ2Xs34k28Lnqtto9,,9026916771,9025811771,-1105000
5273,3734,3vScgfDjFapbJ4MxvGk44szGevifsNPMNSLAgpGmSPhk,,0,1100000,1100000
5272,3734,VUUXnZKyT1Zn2Tcr217sTdXymzyJ2Xs34k28Lnqtto9,,9026932299,9025827299,-1105000
5271,3733,AADeH7mqcm98AJxJBPZ9vkgJWusWhemMnHHJXWsk7L5B,,0,1100000,1100000
5270,3733,VUUXnZKyT1Zn2Tcr217sTdXymzyJ2Xs34k28Lnqtto9,,9026947827,9025842827,-1105000
5269,3732,68aYxhSX7rWaVXqCTb6xnZNYrQvMuoPerAfPHfN82FfA,,0,1100000,1100000
5268,3732,VUUXnZKyT1Zn2Tcr217sTdXymzyJ2Xs34k28Lnqtto9,,9026963355,9025858355,-1105000
5267,3731,GFunzMs2QacbdPvyptVXkJL58Uw77qLGTVtbMDT9Hz7T,,0,1100000,1100000
5266,3731,VUUXnZKyT1Zn2Tcr217sTdXymzyJ2Xs34k28Lnqtto9,,9026978883,9025873883,-1105000
5265,3730,9MXrUCPEty2rVHPq9bnwndzBBbmb7hza5VQUqcSFkvW9,,0,1100000,1100000
5264,3730,VUUXnZKyT1Zn2Tcr217sTdXymzyJ2Xs34k28Lnqtto9,,9026994485,9025889485,-1105000
5263,3729,H2i7uNfTNntiAPQt6TnkGWhN6CZPgY8vFu1pHKVSdrdE,,0,1100000,1100000
5262,3729,VUUXnZKyT1Zn2Tcr217sTdXymzyJ2Xs34k28Lnqtto9,,9027010087,9025905087,-1105000
5261,3728,99cxQkqFzxk9D3eTPehyfLtk62f9nK2F3RnPKqA3BYaC,,0,1100000,1100000
5260,3728,VUUXnZKyT1Zn2Tcr217sTdXymzyJ2Xs34k28Lnqtto9,,9027026937,9025921937,-1105000
5259,3727,GjtynFhXoiWVsMJqhG5ZkVAnrcWYzHCePU8F1fzUCL5b,,0,1100000,1100000
5258,3727,VUUXnZKyT1Zn2Tcr217sTdXymzyJ2Xs34k28Lnqtto9,,9027043787,9025938787,-1105000
5257,3726,8EnSCs5MT9Ycjk4jMT4GJAZu7NpoCJg6sWs8yAPjsbGa,,0,1100000,1100000
5256,3726,VUUXnZKyT1Zn2Tcr217sTdXymzyJ2Xs34k28Lnqtto9,,9027060637,9025955637,-1105000
5255,3725,HfvWye9z68jHWsDZFtDfmrp48GNLmFydnGsnLmKQnNdy,,0,1100000,1100000
5254,3725,VUUXnZKyT1Zn2Tcr217sTdXymzyJ2Xs34k28Lnqtto9,,9027077487,9025972487,-1105000
5253,3724,G7uhYVA7YhxjoZHED3Baxydo9BrxrraQ9jaf1LVP4ESy,,0,1100000,1100000
5252,3724,VUUXnZKyT1Zn2Tcr217sTdXymzyJ2Xs34k28Lnqtto9,,9027094337,9025989337,-1105000
5251,3722,8NpNmntfm9eGHdELmciNPtTVnrAXhScF7vggfzRtTdnr,,489949834,489944247,-5587
5250,3721,8NpNmntfm9eGHdELmciNPtTVnrAXhScF7vggfzRtTdnr,,489965813,489960243,-5570
5249,3720,8NpNmntfm9eGHdELmciNPtTVnrAXhScF7vggfzRtTdnr,,489976999,489971247,-5752
5248,3719,3AVi9Tg9Uo68tJfuvoKvqKNWKkC5wPdSSdeBnizKZ6jT,,2240708,2244558,3850
5247,3719,8NpNmntfm9eGHdELmciNPtTVnrAXhScF7vggfzRtTdnr,,489985849,489976999,-8850
5246,3718,9UQwYrBhwuKPEvzyk7EJFcC31Hmu1XdQ2VFvw4haEQ5Q,,0,1100000,1100000
5245,3718,VUUXnZKyT1Zn2Tcr217sTdXymzyJ2Xs34k28Lnqtto9,,9029896935,9028791935,-1105000
5244,3717,8NpNmntfm9eGHdELmciNPtTVnrAXhScF7vggfzRtTdnr,,490005983,490000418,-5565
5243,3716,8NpNmntfm9eGHdELmciNPtTVnrAXhScF7vggfzRtTdnr,,490011572,490005983,-5589
5242,3715,8NpNmntfm9eGHdELmciNPtTVnrAXhScF7vggfzRtTdnr,,490017285,490011572,-5713
5241,3714,DfXygSm4jCyNCybVYYK6DwvWqjKee8pbDmJGcLWNDXjh,,4412661,4417544,4883
5240,3714,8NpNmntfm9eGHdELmciNPtTVnrAXhScF7vggfzRtTdnr,,490027168,490017285,-9883
5239,3713,99999ocGGdLH45WazXhY3kmLc98iSNm7bL2nTH15TwTA,,199470945,199465366,-5579
5238,3712,6nLnan6mpnMCHzuyi8sGP4t7ivPz5ZsHkipnY5MWjv3Z,,0,1100000,1100000
5237,3712,VUUXnZKyT1Zn2Tcr217sTdXymzyJ2Xs34k28Lnqtto9,,9031062493,9029957493,-1105000
5236,3711,2ATZVg3YXkbNNoeuyPm8xCWwseTKponjHVhRafBTXpSk,,0,1100000,1100000
5235,3711,VUUXnZKyT1Zn2Tcr217sTdXymzyJ2Xs34k28Lnqtto9,,9031079499,9029974499,-1105000
5234,3710,99999ocGGdLH45WazXhY3kmLc98iSNm7bL2nTH15TwTA,,199476908,199470945,-5963
5233,3709,99999ocGGdLH45WazXhY3kmLc98iSNm7bL2nTH15TwTA,,199482814,199476908,-5906
5232,3708,99999ocGGdLH45WazXhY3kmLc98iSNm7bL2nTH15TwTA,,199488796,199482814,-5982
5231,3707,99999ocGGdLH45WazXhY3kmLc98iSNm7bL2nTH15TwTA,,200363982,200358356,-5626
5230,3706,99999ocGGdLH45WazXhY3kmLc98iSNm7bL2nTH15TwTA,,200513766,200508015,-5751
5229,3705,5V2SfJUk3Tse3DsSHKsyc6yFsb4w8troCVRJXRGinjfu,,0,1100000,1100000
5228,3705,VUUXnZKyT1Zn2Tcr217sTdXymzyJ2Xs34k28Lnqtto9,,9033886211,9032781211,-1105000
5227,3704,99999ocGGdLH45WazXhY3kmLc98iSNm7bL2nTH15TwTA,,200519464,200513766,-5698
5226,3703,VUUXnZKyT1Zn2Tcr217sTdXymzyJ2Xs34k28Lnqtto9,,9034888297,9034880901,-7396
5225,3702,99999ocGGdLH45WazXhY3kmLc98iSNm7bL2nTH15TwTA,,200963870,200958168,-5702
5224,3701,99999ocGGdLH45WazXhY3kmLc98iSNm7bL2nTH15TwTA,,200969767,200963870,-5897
5223,3700,99999ocGGdLH45WazXhY3kmLc98iSNm7bL2nTH15TwTA,,201669565,201663545,-6020
5222,3699,99999ocGGdLH45WazXhY3kmLc98iSNm7bL2nTH15TwTA,,201922891,201916999,-5892
5221,3698,99999ocGGdLH45WazXhY3kmLc98iSNm7bL2nTH15TwTA,,202777381,202771479,-5902
5220,3697,99999ocGGdLH45WazXhY3kmLc98iSNm7bL2nTH15TwTA,,202783279,202777381,-5898
5219,3696,99999ocGGdLH45WazXhY3kmLc98iSNm7bL2nTH15TwTA,,202794848,202788992,-5856
5218,3695,99999ocGGdLH45WazXhY3kmLc98iSNm7bL2nTH15TwTA,,202800761,202794848,-5913
5217,3694,VUUXnZKyT1Zn2Tcr217sTdXymzyJ2Xs34k28Lnqtto9,,9045317807,9045310069,-7738
5216,3693,VUUXnZKyT1Zn2Tcr217sTdXymzyJ2Xs34k28Lnqtto9,,9047667680,9047659527,-8153
5215,3692,99999ocGGdLH45WazXhY3kmLc98iSNm7bL2nTH15TwTA,,204410447,204404656,-5791
5214,3689,VUUXnZKyT1Zn2Tcr217sTdXymzyJ2Xs34k28Lnqtto9,,9047675839,9047667680,-8159
5213,3688,99999ocGGdLH45WazXhY3kmLc98iSNm7bL2nTH15TwTA,,204416455,204410447,-6008
5212,3686,AYbw8wCz4ZHPjPZMtSgmALEjoJgPy9UeQbFrwpXBTpdb,,0,1100000,1100000
5211,3686,VUUXnZKyT1Zn2Tcr217sTdXymzyJ2Xs34k28Lnqtto9,,9054853855,9053748855,-1105000
5210,3685,99999ocGGdLH45WazXhY3kmLc98iSNm7bL2nTH15TwTA,,206617388,206611678,-5710
5209,3684,99999ocGGdLH45WazXhY3kmLc98iSNm7bL2nTH15TwTA,,207339029,207333465,-5564
5208,3682,99999ocGGdLH45WazXhY3kmLc98iSNm7bL2nTH15TwTA,,207922404,207916403,-6001
5207,3681,VUUXnZKyT1Zn2Tcr217sTdXymzyJ2Xs34k28Lnqtto9,,9057407445,9057400045,-7400
5206,3680,99999ocGGdLH45WazXhY3kmLc98iSNm7bL2nTH15TwTA,,209615612,209609911,-5701
5205,3679,99999ocGGdLH45WazXhY3kmLc98iSNm7bL2nTH15TwTA,,209621550,209615612,-5938
5204,3678,4K8KN1unPyRHbqiubnsHtGy3ajkTHEFWKwnnX2KZsibU,,0,1100000,1100000
5203,3678,VUUXnZKyT1Zn2Tcr217sTdXymzyJ2Xs34k28Lnqtto9,,9063499076,9062394076,-1105000
5202,3677,99999ocGGdLH45WazXhY3kmLc98iSNm7bL2nTH15TwTA,,209627556,209621550,-6006
5201,3676,CZA6yQQEVUoyDbCGgiQpES4MZANx8D1vhnmjU4jk3W66,,0,1100000,1100000
5200,3676,VUUXnZKyT1Zn2Tcr217sTdXymzyJ2Xs34k28Lnqtto9,,9063515660,9062410660,-1105000
5199,3675,99999ocGGdLH45WazXhY3kmLc98iSNm7bL2nTH15TwTA,,209633304,209627556,-5748
5198,3674,99999ocGGdLH45WazXhY3kmLc98iSNm7bL2nTH15TwTA,,209638995,209633304,-5691
5197,3673,99999ocGGdLH45WazXhY3kmLc98iSNm7bL2nTH15TwTA,,209644572,209638995,-5577
5196,3672,99999ocGGdLH45WazXhY3kmLc98iSNm7bL2nTH15TwTA,,209650438,209644572,-5866
5195,3671,99999ocGGdLH45WazXhY3kmLc98iSNm7bL2nTH15TwTA,,209656078,209650438,-5640
5194,3670,99999ocGGdLH45WazXhY3kmLc98iSNm7bL2nTH15TwTA,,209661628,209656078,-5550
5193,3669,99999ocGGdLH45WazXhY3kmLc98iSNm7bL2nTH15TwTA,,209667524,209661628,-5896
5192,3668,5HKjugjLk4yg2BpczGWc5AJtE2tCke2AyV6yhFYupMa1,,0,1100000,1100000
5191,3668,VUUXnZKyT1Zn2Tcr217sTdXymzyJ2Xs34k28Lnqtto9,,9063531612,9062426612,-1105000
5190,3667,99999ocGGdLH45WazXhY3kmLc98iSNm7bL2nTH15TwTA,,209673281,209667524,-5757
5189,3666,99999ocGGdLH45WazXhY3kmLc98iSNm7bL2nTH15TwTA,,209678909,209673281,-5628
5188,3665,99999ocGGdLH45WazXhY3kmLc98iSNm7bL2nTH15TwTA,,209684617,209678909,-5708
5187,3664,99999ocGGdLH45WazXhY3kmLc98iSNm7bL2nTH15TwTA,,213235630,213229831,-5799
5186,3663,99999ocGGdLH45WazXhY3kmLc98iSNm7bL2nTH15TwTA,,213241488,213235630,-5858
5185,3662,99999ocGGdLH45WazXhY3kmLc98iSNm7bL2nTH15TwTA,,213247488,213241488,-6000
5184,3661,99999ocGGdLH45WazXhY3kmLc98iSNm7bL2nTH15TwTA,,213253040,213247488,-5552
5183,3660,VUUXnZKyT1Zn2Tcr217sTdXymzyJ2Xs34k28Lnqtto9,,9069156611,9069138780,-17831
5182,3659,99999ocGGdLH45WazXhY3kmLc98iSNm7bL2nTH15TwTA,,213258782,213253040,-5742
5181,3658,99999ocGGdLH45WazXhY3kmLc98iSNm7bL2nTH15TwTA,,213264715,213258782,-5933
5180,3657,VUUXnZKyT1Zn2Tcr217sTdXymzyJ2Xs34k28Lnqtto9,,9069174453,9069156611,-17842
5179,3656,99999ocGGdLH45WazXhY3kmLc98iSNm7bL2nTH15TwTA,,213270414,213264715,-5699
5178,3655,99999ocGGdLH45WazXhY3kmLc98iSNm7bL2nTH15TwTA,,213276389,213270414,-5975
5177,3654,99999ocGGdLH45WazXhY3kmLc98iSNm7bL2nTH15TwTA,,213282125,213276389,-5736
5176,3653,2hSHWBC3VtebuLogNuRcDx8Hd3gNufPvysBNSix89m2q,,0,1100000,1100000
5175,3653,VUUXnZKyT1Zn2Tcr217sTdXymzyJ2Xs34k28Lnqtto9,,9069190458,9068085458,-1105000
5174,3652,99999ocGGdLH45WazXhY3kmLc98iSNm7bL2nTH15TwTA,,213288130,213282125,-6005
5173,3651,99999ocGGdLH45WazXhY3kmLc98iSNm7bL2nTH15TwTA,,213294113,213288130,-5983
5172,3650,99999ocGGdLH45WazXhY3kmLc98iSNm7bL2nTH15TwTA,,213299749,213294113,-5636
5171,3649,99999ocGGdLH45WazXhY3kmLc98iSNm7bL2nTH15TwTA,,213305740,213299749,-5991
5170,3648,99999ocGGdLH45WazXhY3kmLc98iSNm7bL2nTH15TwTA,,213311721,213305740,-5981
5169,3647,99999ocGGdLH45WazXhY3kmLc98iSNm7bL2nTH15TwTA,,213317442,213311721,-5721
5168,3646,99999ocGGdLH45WazXhY3kmLc98iSNm7bL2nTH15TwTA,,213323347,213317442,-5905
5167,3645,99999ocGGdLH45WazXhY3kmLc98iSNm7bL2nTH15TwTA,,213329210,213323347,-5863
4602,3494,VUUXnZKyT1Zn2Tcr217sTdXymzyJ2Xs34k28Lnqtto9,,4282959289,4282954289,-5000
4601,3493,VUUXnZKyT1Zn2Tcr217sTdXymzyJ2Xs34k28Lnqtto9,,4282964289,4282959289,-5000
4600,3492,VUUXnZKyT1Zn2Tcr217sTdXymzyJ2Xs34k28Lnqtto9,,4282969289,4282964289,-5000
4599,3491,E1KKbbJTc5UXGjVbRGqUtyCAMypy9TNje9Mb2fjoor5s,,0,1100000,1100000
4598,3491,VUUXnZKyT1Zn2Tcr217sTdXymzyJ2Xs34k28Lnqtto9,,4284074289,4282969289,-1105000
4597,3490,ADuUkR4vqLUMWXxW9gh6D6L8pMSawimctcNZ5pGwDcEt,,1410230,1413627,3397
4596,3490,EUDj8idRk3hwHvUV8M7LmPfvrCNADoMGDd7ZX4s38ntA,,156005006,155996609,-8397
4595,3489,BWCQUz43UZqzSb7ysUaWJRNPhMWL48KAM1R2E1xdf4Bw,,418245643,418239928,-5715
4594,3488,VUUXnZKyT1Zn2Tcr217sTdXymzyJ2Xs34k28Lnqtto9,,4282989878,4282984878,-5000
4593,3487,VUUXnZKyT1Zn2Tcr217sTdXymzyJ2Xs34k28Lnqtto9,,4282994878,4282989878,-5000
4592,3486,VUUXnZKyT1Zn2Tcr217sTdXymzyJ2Xs34k28Lnqtto9,,4282999878,4282994878,-5000
4591,3485,3bxJ5WxzFXX3LfALJ8yiNJUkFYDgzuMhuE5gbcDkrJTf,,0,1100000,1100000
4590,3485,VUUXnZKyT1Zn2Tcr217sTdXymzyJ2Xs34k28Lnqtto9,,4284104878,4282999878,-1105000
4589,3484,VUUXnZKyT1Zn2Tcr217sTdXymzyJ2Xs34k28Lnqtto9,,4283020429,4283015429,-5000
4588,3483,VUUXnZKyT1Zn2Tcr217sTdXymzyJ2Xs34k28Lnqtto9,,4283025429,4283020429,-5000
4587,3482,VUUXnZKyT1Zn2Tcr217sTdXymzyJ2Xs34k28Lnqtto9,,4283030429,4283025429,-5000
4586,3481,FHcYDdYDVPHfczuvS6fuPCJwBvEZuF9XBmxeLmhs4V8,,0,1100000,1100000
4585,3481,VUUXnZKyT1Zn2Tcr217sTdXymzyJ2Xs34k28Lnqtto9,,4284135429,4283030429,-1105000
4584,3480,VUUXnZKyT1Zn2Tcr217sTdXymzyJ2Xs34k28Lnqtto9,,4283050980,4283045980,-5000
4583,3479,VUUXnZKyT1Zn2Tcr217sTdXymzyJ2Xs34k28Lnqtto9,,4283055980,4283050980,-5000
4582,3478,VUUXnZKyT1Zn2Tcr217sTdXymzyJ2Xs34k28Lnqtto9,,4283060980,4283055980,-5000
4581,3477,orSUrVGBETeNXf5FWphHL2rrQWvhRtbQbinkRVGfBRg,,0,1100000,1100000
4580,3477,VUUXnZKyT1Zn2Tcr217sTdXymzyJ2Xs34k28Lnqtto9,,4284165980,4283060980,-1105000
4579,3476,VUUXnZKyT1Zn2Tcr217sTdXymzyJ2Xs34k28Lnqtto9,,4283081569,4283076569,-5000
4578,3475,VUUXnZKyT1Zn2Tcr217sTdXymzyJ2Xs34k28Lnqtto9,,4283086569,4283081569,-5000
4577,3474,VUUXnZKyT1Zn2Tcr217sTdXymzyJ2Xs34k28Lnqtto9,,4283091569,4283086569,-5000
4576,3473,BSnPM2zcsJgbCco1ctYMRMFx7Ui131Mea235pA5G9AsY,,0,1100000,1100000
4575,3473,VUUXnZKyT1Zn2Tcr217sTdXymzyJ2Xs34k28Lnqtto9,,4284196569,4283091569,-1105000
4574,3472,VUUXnZKyT1Zn2Tcr217sTdXymzyJ2Xs34k28Lnqtto9,,4283112120,4283107120,-5000
4573,3471,VUUXnZKyT1Zn2Tcr217sTdXymzyJ2Xs34k28Lnqtto9,,4283117120,4283112120,-5000
4572,3470,VUUXnZKyT1Zn2Tcr217sTdXymzyJ2Xs34k28Lnqtto9,,4283122120,4283117120,-5000
4571,3469,4G5oKKSt2UMFkeSNNHm24nMQSYyZ2YN3AdD5TWCJUCC2,,0,1100000,1100000
4570,3469,VUUXnZKyT1Zn2Tcr217sTdXymzyJ2Xs34k28Lnqtto9,,4284227120,4283122120,-1105000
4569,3468,VUUXnZKyT1Zn2Tcr217sTdXymzyJ2Xs34k28Lnqtto9,,4283142671,4283137671,-5000
4568,3467,VUUXnZKyT1Zn2Tcr217sTdXymzyJ2Xs34k28Lnqtto9,,4283147671,4283142671,-5000
4567,3466,VUUXnZKyT1Zn2Tcr217sTdXymzyJ2Xs34k28Lnqtto9,,4283152671,4283147671,-5000
4566,3465,J4WASdRaYWWXNE3FGCy8qNmw42RQfB6YohysJFNDw9bm,,0,1100000,1100000
4565,3465,VUUXnZKyT1Zn2Tcr217sTdXymzyJ2Xs34k28Lnqtto9,,4284257671,4283152671,-1105000
4564,3464,VUUXnZKyT1Zn2Tcr217sTdXymzyJ2Xs34k28Lnqtto9,,4283173222,4283168222,-5000
4563,3463,VUUXnZKyT1Zn2Tcr217sTdXymzyJ2Xs34k28Lnqtto9,,4283178222,4283173222,-5000
4562,3462,VUUXnZKyT1Zn2Tcr217sTdXymzyJ2Xs34k28Lnqtto9,,4283183222,4283178222,-5000
4561,3461,BJecx12mFPeiDthoUjhF7uN4XhHsa35CQVQdvr57imTH,,0,1100000,1100000
4560,3461,VUUXnZKyT1Zn2Tcr217sTdXymzyJ2Xs34k28Lnqtto9,,4284288222,4283183222,-1105000
4559,3460,VUUXnZKyT1Zn2Tcr217sTdXymzyJ2Xs34k28Lnqtto9,,4283204355,4283199355,-5000
4558,3459,VUUXnZKyT1Zn2Tcr217sTdXymzyJ2Xs34k28Lnqtto9,,4283209355,4283204355,-5000
4557,3458,VUUXnZKyT1Zn2Tcr217sTdXymzyJ2Xs34k28Lnqtto9,,4283214355,4283209355,-5000
4556,3457,6uWczfctoqcopeKgYdTYjj7d6RjHThSGYDTz7NyK1F8q,,0,1100000,1100000
4555,3457,VUUXnZKyT1Zn2Tcr217sTdXymzyJ2Xs34k28Lnqtto9,,4284319355,4283214355,-1105000
4554,3456,VUUXnZKyT1Zn2Tcr217sTdXymzyJ2Xs34k28Lnqtto9,,4283234944,4283229944,-5000
4553,3455,VUUXnZKyT1Zn2Tcr217sTdXymzyJ2Xs34k28Lnqtto9,,4283239944,4283234944,-5000
4552,3454,VUUXnZKyT1Zn2Tcr217sTdXymzyJ2Xs34k28Lnqtto9,,4283244944,4283239944,-5000
4551,3453,Gq685rMMt8nnmWSpYZYhjzNF8ARm8YeFduyEsJ6CarxB,,0,1100000,1100000
4550,3453,VUUXnZKyT1Zn2Tcr217sTdXymzyJ2Xs34k28Lnqtto9,,4284349944,4283244944,-1105000
4549,3452,Cw8CFyM9FkoMi7K7Crf6HNQqf4uEMzpKw6QNghXLvLkY,,1004388,1008434,4046
4548,3452,EUDj8idRk3hwHvUV8M7LmPfvrCNADoMGDd7ZX4s38ntA,,156014052,156005006,-9046
4547,3451,VUUXnZKyT1Zn2Tcr217sTdXymzyJ2Xs34k28Lnqtto9,,4284357340,4284349944,-7396
4546,3450,VUUXnZKyT1Zn2Tcr217sTdXymzyJ2Xs34k28Lnqtto9,,4284364736,4284357340,-7396
4545,3449,VUUXnZKyT1Zn2Tcr217sTdXymzyJ2Xs34k28Lnqtto9,,4284372133,4284364736,-7397
4544,3448,BWCQUz43UZqzSb7ysUaWJRNPhMWL48KAM1R2E1xdf4Bw,,418251508,418245643,-5865
4543,3447,ADaUMid9yfUytqMBgopwjb2DTLSokTSzL1zt6iGPaS49,,1109680,1113247,3567
4542,3447,EUDj8idRk3hwHvUV8M7LmPfvrCNADoMGDd7ZX4s38ntA,,156022619,156014052,-8567
4541,3446,ADaUMid9yfUytqMBgopwjb2DTLSokTSzL1zt6iGPaS49,,1106184,1109680,3496
4540,3446,EUDj8idRk3hwHvUV8M7LmPfvrCNADoMGDd7ZX4s38ntA,,156031115,156022619,-8496
4539,3445,3AVi9Tg9Uo68tJfuvoKvqKNWKkC5wPdSSdeBnizKZ6jT,,995322,999187,3865
4538,3445,EUDj8idRk3hwHvUV8M7LmPfvrCNADoMGDd7ZX4s38ntA,,156039980,156031115,-8865
4537,3444,Cw8CFyM9FkoMi7K7Crf6HNQqf4uEMzpKw6QNghXLvLkY,,985757,989939,4182
4536,3444,EUDj8idRk3hwHvUV8M7LmPfvrCNADoMGDd7ZX4s38ntA,,156049162,156039980,-9182
4535,3443,ADuUkR4vqLUMWXxW9gh6D6L8pMSawimctcNZ5pGwDcEt,,1327714,1332200,4486
4534,3443,EUDj8idRk3hwHvUV8M7LmPfvrCNADoMGDd7ZX4s38ntA,,156058648,156049162,-9486
4533,3442,A9eLa4Rr7Z78ovaiHQacsVsYRygtN32Pq48DhSLdhKoT,,717683153,717677220,-5933
4532,3441,A9eLa4Rr7Z78ovaiHQacsVsYRygtN32Pq48DhSLdhKoT,,717688974,717683153,-5821
4531,3440,A9eLa4Rr7Z78ovaiHQacsVsYRygtN32Pq48DhSLdhKoT,,717694886,717688974,-5912
4530,3439,BWCQUz43UZqzSb7ysUaWJRNPhMWL48KAM1R2E1xdf4Bw,,418257464,418251508,-5956
4529,3438,BWCQUz43UZqzSb7ysUaWJRNPhMWL48KAM1R2E1xdf4Bw,,418263317,418257464,-5853
4528,3437,VUUXnZKyT1Zn2Tcr217sTdXymzyJ2Xs34k28Lnqtto9,,4284389934,4284372133,-17801
4527,3436,A9eLa4Rr7Z78ovaiHQacsVsYRygtN32Pq48DhSLdhKoT,,717700650,717694886,-5764
4526,3435,VUUXnZKyT1Zn2Tcr217sTdXymzyJ2Xs34k28Lnqtto9,,4284397332,4284389934,-7398
4525,3434,BWCQUz43UZqzSb7ysUaWJRNPhMWL48KAM1R2E1xdf4Bw,,418269099,418263317,-5782
4524,3433,VUUXnZKyT1Zn2Tcr217sTdXymzyJ2Xs34k28Lnqtto9,,4284415130,4284397332,-17798
4523,3432,BWCQUz43UZqzSb7ysUaWJRNPhMWL48KAM1R2E1xdf4Bw,,418274976,418269099,-5877
4522,3431,VUUXnZKyT1Zn2Tcr217sTdXymzyJ2Xs34k28Lnqtto9,,4284422530,4284415130,-7400
4521,3430,VUUXnZKyT1Zn2Tcr217sTdXymzyJ2Xs34k28Lnqtto9,,4284429926,4284422530,-7396
4520,3429,A9eLa4Rr7Z78ovaiHQacsVsYRygtN32Pq48DhSLdhKoT,,717706552,717700650,-5902
4519,3428,A9eLa4Rr7Z78ovaiHQacsVsYRygtN32Pq48DhSLdhKoT,,717712025,717706552,-5473
4518,3427,VUUXnZKyT1Zn2Tcr217sTdXymzyJ2Xs34k28Lnqtto9,,4284449260,4284429926,-19334
4517,3426,VUUXnZKyT1Zn2Tcr217sTdXymzyJ2Xs34k28Lnqtto9,,4284468585,4284449260,-19325
4516,3425,BWCQUz43UZqzSb7ysUaWJRNPhMWL48KAM1R2E1xdf4Bw,,418280779,418274976,-5803
4515,3424,A9eLa4Rr7Z78ovaiHQacsVsYRygtN32Pq48DhSLdhKoT,,717718043,717712025,-6018
4514,3423,A9eLa4Rr7Z78ovaiHQacsVsYRygtN32Pq48DhSLdhKoT,,717723526,717718043,-5483
4513,3422,A9eLa4Rr7Z78ovaiHQacsVsYRygtN32Pq48DhSLdhKoT,,717729280,717723526,-5754
4512,3421,BWCQUz43UZqzSb7ysUaWJRNPhMWL48KAM1R2E1xdf4Bw,,418286622,418280779,-5843
4511,3420,BWCQUz43UZqzSb7ysUaWJRNPhMWL48KAM1R2E1xdf4Bw,,418292581,418286622,-5959
4510,3419,A9eLa4Rr7Z78ovaiHQacsVsYRygtN32Pq48DhSLdhKoT,,717735298,717729280,-6018
4509,3418,DttWaMuVvTiduZRnguLF7jNxTgiMBZ1hyAumKUiL2KRL,,3934907,3939782,4875
4508,3418,EUDj8idRk3hwHvUV8M7LmPfvrCNADoMGDd7ZX4s38ntA,,156068523,156058648,-9875
4507,3417,VUUXnZKyT1Zn2Tcr217sTdXymzyJ2Xs34k28Lnqtto9,,4284487893,4284468585,-19308
4506,3416,VUUXnZKyT1Zn2Tcr217sTdXymzyJ2Xs34k28Lnqtto9,,4284507218,4284487893,-19325
4505,3415,A9eLa4Rr7Z78ovaiHQacsVsYRygtN32Pq48DhSLdhKoT,,717741159,717735298,-5861
4504,3414,BWCQUz43UZqzSb7ysUaWJRNPhMWL48KAM1R2E1xdf4Bw,,418298550,418292581,-5969
4503,3413,Cw8CFyM9FkoMi7K7Crf6HNQqf4uEMzpKw6QNghXLvLkY,,12608063,12612083,4020
4502,3413,EUDj8idRk3hwHvUV8M7LmPfvrCNADoMGDd7ZX4s38ntA,,156077543,156068523,-9020
4501,3412,VUUXnZKyT1Zn2Tcr217sTdXymzyJ2Xs34k28Lnqtto9,,4284526547,4284507218,-19329
4500,3411,A9eLa4Rr7Z78ovaiHQacsVsYRygtN32Pq48DhSLdhKoT,,717746495,717741159,-5336
4499,3410,BWCQUz43UZqzSb7ysUaWJRNPhMWL48KAM1R2E1xdf4Bw,,418304224,418298550,-5674
4498,3409,A9eLa4Rr7Z78ovaiHQacsVsYRygtN32Pq48DhSLdhKoT,,717752585,717746495,-6090
4497,3408,ADaUMid9yfUytqMBgopwjb2DTLSokTSzL1zt6iGPaS49,,13161465,13166023,4558
4496,3408,EUDj8idRk3hwHvUV8M7LmPfvrCNADoMGDd7ZX4s38ntA,,156087101,156077543,-9558
4495,3407,BWCQUz43UZqzSb7ysUaWJRNPhMWL48KAM1R2E1xdf4Bw,,418310063,418304224,-5839
4494,3406,A9eLa4Rr7Z78ovaiHQacsVsYRygtN32Pq48DhSLdhKoT,,717758672,717752585,-6087
4493,3405,96gYZGLnJYVFmbjzopPSU6QiEV5fGqZNyN9nmNhvrZU5,,1080870,1085229,4359
4492,3405,EUDj8idRk3hwHvUV8M7LmPfvrCNADoMGDd7ZX4s38ntA,,156096460,156087101,-9359
4491,3404,VUUXnZKyT1Zn2Tcr217sTdXymzyJ2Xs34k28Lnqtto9,,4284545875,4284526547,-19328
4490,3403,ADuUkR4vqLUMWXxW9gh6D6L8pMSawimctcNZ5pGwDcEt,,2742323,2746315,3992
4489,3403,EUDj8idRk3hwHvUV8M7LmPfvrCNADoMGDd7ZX4s38ntA,,156105452,156096460,-8992
4488,3402,A9eLa4Rr7Z78ovaiHQacsVsYRygtN32Pq48DhSLdhKoT,,717764156,717758672,-5484
4487,3401,BWCQUz43UZqzSb7ysUaWJRNPhMWL48KAM1R2E1xdf4Bw,,418315929,418310063,-5866
4486,3400,HFqU5x63VTqvQss8hp11i4wVV8bD44PvwucfZ2bU7gRe,,1566338,1570687,4349
4485,3400,EUDj8idRk3hwHvUV8M7LmPfvrCNADoMGDd7ZX4s38ntA,,156114801,156105452,-9349
4484,3399,VUUXnZKyT1Zn2Tcr217sTdXymzyJ2Xs34k28Lnqtto9,,4284565196,4284545875,-19321
4483,3398,VUUXnZKyT1Zn2Tcr217sTdXymzyJ2Xs34k28Lnqtto9,,4284584507,4284565196,-19311
4482,3397,BWCQUz43UZqzSb7ysUaWJRNPhMWL48KAM1R2E1xdf4Bw,,418321677,418315929,-5748
4481,3396,A9eLa4Rr7Z78ovaiHQacsVsYRygtN32Pq48DhSLdhKoT,,717769907,717764156,-5751
4480,3395,A9eLa4Rr7Z78ovaiHQacsVsYRygtN32Pq48DhSLdhKoT,,717775858,717769907,-5951
4479,3394,DfXygSm4jCyNCybVYYK6DwvWqjKee8pbDmJGcLWNDXjh,,3277936,3282300,4364
4478,3394,EUDj8idRk3hwHvUV8M7LmPfvrCNADoMGDd7ZX4s38ntA,,156124165,156114801,-9364
4477,3393,A9eLa4Rr7Z78ovaiHQacsVsYRygtN32Pq48DhSLdhKoT,,717781435,717775858,-5577
4476,3392,BWCQUz43UZqzSb7ysUaWJRNPhMWL48KAM1R2E1xdf4Bw,,418327337,418321677,-5660
4475,3391,ADaUMid9yfUytqMBgopwjb2DTLSokTSzL1zt6iGPaS49,,2638974,2642206,3232
4474,3391,EUDj8idRk3hwHvUV8M7LmPfvrCNADoMGDd7ZX4s38ntA,,156132397,156124165,-8232
4473,3390,VUUXnZKyT1Zn2Tcr217sTdXymzyJ2Xs34k28Lnqtto9,,4284603844,4284584507,-19337
4472,3389,VUUXnZKyT1Zn2Tcr217sTdXymzyJ2Xs34k28Lnqtto9,,4284623164,4284603844,-19320
4471,3388,VUUXnZKyT1Zn2Tcr217sTdXymzyJ2Xs34k28Lnqtto9,,4284642473,4284623164,-19309
4470,3387,BWCQUz43UZqzSb7ysUaWJRNPhMWL48KAM1R2E1xdf4Bw,,418333068,418327337,-5731
4469,3386,A9eLa4Rr7Z78ovaiHQacsVsYRygtN32Pq48DhSLdhKoT,,717787445,717781435,-6010
4468,3385,DttWaMuVvTiduZRnguLF7jNxTgiMBZ1hyAumKUiL2KRL,,978304,982889,4585
4467,3385,EUDj8idRk3hwHvUV8M7LmPfvrCNADoMGDd7ZX4s38ntA,,156141982,156132397,-9585
4466,3384,A9eLa4Rr7Z78ovaiHQacsVsYRygtN32Pq48DhSLdhKoT,,717793352,717787445,-5907
4465,3383,VUUXnZKyT1Zn2Tcr217sTdXymzyJ2Xs34k28Lnqtto9,,4283559089,4283554089,-5000
4464,3382,VUUXnZKyT1Zn2Tcr217sTdXymzyJ2Xs34k28Lnqtto9,,4283564089,4283559089,-5000
4463,3381,VUUXnZKyT1Zn2Tcr217sTdXymzyJ2Xs34k28Lnqtto9,,4283569089,4283564089,-5000
4462,3380,C3gVUBdojFedBe2Q2NsuQDeaimhSHqjmkrbWhL9ZECs7,,0,1100000,1100000
4461,3380,VUUXnZKyT1Zn2Tcr217sTdXymzyJ2Xs34k28Lnqtto9,,4284674089,4283569089,-1105000
4460,3379,ADuUkR4vqLUMWXxW9gh6D6L8pMSawimctcNZ5pGwDcEt,,2017495,2021593,4098
4459,3379,EUDj8idRk3hwHvUV8M7LmPfvrCNADoMGDd7ZX4s38ntA,,156151080,156141982,-9098
4458,3378,BWCQUz43UZqzSb7ysUaWJRNPhMWL48KAM1R2E1xdf4Bw,,418338885,418333068,-5817
4457,3377,A9eLa4Rr7Z78ovaiHQacsVsYRygtN32Pq48DhSLdhKoT,,717798746,717793352,-5394
4456,3376,ADuUkR4vqLUMWXxW9gh6D6L8pMSawimctcNZ5pGwDcEt,,1008560,1012692,4132
4455,3376,EUDj8idRk3hwHvUV8M7LmPfvrCNADoMGDd7ZX4s38ntA,,161385793,161376661,-9132
4454,3375,Cw8CFyM9FkoMi7K7Crf6HNQqf4uEMzpKw6QNghXLvLkY,,963201,967667,4466
4453,3375,EUDj8idRk3hwHvUV8M7LmPfvrCNADoMGDd7ZX4s38ntA,,161395259,161385793,-9466
4452,3374,DfXygSm4jCyNCybVYYK6DwvWqjKee8pbDmJGcLWNDXjh,,964546,968904,4358
4451,3374,EUDj8idRk3hwHvUV8M7LmPfvrCNADoMGDd7ZX4s38ntA,,161404617,161395259,-9358
4450,3373,ADaUMid9yfUytqMBgopwjb2DTLSokTSzL1zt6iGPaS49,,956560,960898,4338
4449,3373,EUDj8idRk3hwHvUV8M7LmPfvrCNADoMGDd7ZX4s38ntA,,161413955,161404617,-9338
4448,3372,Cw8CFyM9FkoMi7K7Crf6HNQqf4uEMzpKw6QNghXLvLkY,,958810,963201,4391
4447,3372,EUDj8idRk3hwHvUV8M7LmPfvrCNADoMGDd7ZX4s38ntA,,161423346,161413955,-9391
4446,3371,BoYfJDbr5j8TYbr2w66DBNcXNhafHysbQngupVX4NArt,,231635458,231630356,-5102
4445,3370,BWCQUz43UZqzSb7ysUaWJRNPhMWL48KAM1R2E1xdf4Bw,,421507243,421501414,-5829
4444,3369,2gLgfDKRhzMkDpCWk2us4LCebJ9HbiapfFjCTHQqxC9g,,79232398,79227398,-5000
4443,3368,BoYfJDbr5j8TYbr2w66DBNcXNhafHysbQngupVX4NArt,,231640593,231635458,-5135
4442,3367,VUUXnZKyT1Zn2Tcr217sTdXymzyJ2Xs34k28Lnqtto9,,4299979872,4299972475,-7397
4441,3366,A9eLa4Rr7Z78ovaiHQacsVsYRygtN32Pq48DhSLdhKoT,,723924096,723918169,-5927
4440,3365,VUUXnZKyT1Zn2Tcr217sTdXymzyJ2Xs34k28Lnqtto9,,4299987271,4299979872,-7399
4439,3364,BWCQUz43UZqzSb7ysUaWJRNPhMWL48KAM1R2E1xdf4Bw,,421512971,421507243,-5728
4438,3363,VUUXnZKyT1Zn2Tcr217sTdXymzyJ2Xs34k28Lnqtto9,,4299994672,4299987271,-7401
4437,3362,VUUXnZKyT1Zn2Tcr217sTdXymzyJ2Xs34k28Lnqtto9,,4300002071,4299994672,-7399
4436,3361,VUUXnZKyT1Zn2Tcr217sTdXymzyJ2Xs34k28Lnqtto9,,4300009468,4300002071,-7397
4435,3360,VUUXnZKyT1Zn2Tcr217sTdXymzyJ2Xs34k28Lnqtto9,,4300016865,4300009468,-7397
4434,3359,A9eLa4Rr7Z78ovaiHQacsVsYRygtN32Pq48DhSLdhKoT,,723929924,723924096,-5828
4433,3358,2gLgfDKRhzMkDpCWk2us4LCebJ9HbiapfFjCTHQqxC9g,,79237398,79232398,-5000
4432,3357,BoYfJDbr5j8TYbr2w66DBNcXNhafHysbQngupVX4NArt,,231645698,231640593,-5105
4431,3356,A9eLa4Rr7Z78ovaiHQacsVsYRygtN32Pq48DhSLdhKoT,,723935399,723929924,-5475
4430,3355,BWCQUz43UZqzSb7ysUaWJRNPhMWL48KAM1R2E1xdf4Bw,,421518918,421512971,-5947
4429,3354,BoYfJDbr5j8TYbr2w66DBNcXNhafHysbQngupVX4NArt,,231650755,231645698,-5057
4428,3353,2gLgfDKRhzMkDpCWk2us4LCebJ9HbiapfFjCTHQqxC9g,,79242398,79237398,-5000
4427,3352,A9eLa4Rr7Z78ovaiHQacsVsYRygtN32Pq48DhSLdhKoT,,723941157,723935399,-5758
4426,3351,BWCQUz43UZqzSb7ysUaWJRNPhMWL48KAM1R2E1xdf4Bw,,421524786,421518918,-5868
4425,3350,2gLgfDKRhzMkDpCWk2us4LCebJ9HbiapfFjCTHQqxC9g,,79247398,79242398,-5000
4424,3349,BoYfJDbr5j8TYbr2w66DBNcXNhafHysbQngupVX4NArt,,231655755,231650755,-5000
4423,3348,A9eLa4Rr7Z78ovaiHQacsVsYRygtN32Pq48DhSLdhKoT,,723946943,723941157,-5786
4422,3347,BWCQUz43UZqzSb7ysUaWJRNPhMWL48KAM1R2E1xdf4Bw,,421530515,421524786,-5729
4421,3346,A9eLa4Rr7Z78ovaiHQacsVsYRygtN32Pq48DhSLdhKoT,,723952267,723946943,-5324
4420,3345,2gLgfDKRhzMkDpCWk2us4LCebJ9HbiapfFjCTHQqxC9g,,79252398,79247398,-5000
4419,3344,VUUXnZKyT1Zn2Tcr217sTdXymzyJ2Xs34k28Lnqtto9,,4326933853,4326926455,-7398
4418,3343,VUUXnZKyT1Zn2Tcr217sTdXymzyJ2Xs34k28Lnqtto9,,4326941253,4326933853,-7400
4417,3342,VUUXnZKyT1Zn2Tcr217sTdXymzyJ2Xs34k28Lnqtto9,,4326948653,4326941253,-7400
4416,3341,2gLgfDKRhzMkDpCWk2us4LCebJ9HbiapfFjCTHQqxC9g,,84612398,84607398,-5000
4415,3340,BWCQUz43UZqzSb7ysUaWJRNPhMWL48KAM1R2E1xdf4Bw,,427787781,427781927,-5854
4414,3339,VUUXnZKyT1Zn2Tcr217sTdXymzyJ2Xs34k28Lnqtto9,,4326956049,4326948653,-7396
4413,3338,2gLgfDKRhzMkDpCWk2us4LCebJ9HbiapfFjCTHQqxC9g,,84617398,84612398,-5000
4412,3337,BWCQUz43UZqzSb7ysUaWJRNPhMWL48KAM1R2E1xdf4Bw,,427793444,427787781,-5663
4411,3336,VUUXnZKyT1Zn2Tcr217sTdXymzyJ2Xs34k28Lnqtto9,,4326963449,4326956049,-7400
4410,3335,2gLgfDKRhzMkDpCWk2us4LCebJ9HbiapfFjCTHQqxC9g,,84622398,84617398,-5000
4409,3334,BWCQUz43UZqzSb7ysUaWJRNPhMWL48KAM1R2E1xdf4Bw,,427799389,427793444,-5945
4408,3333,VUUXnZKyT1Zn2Tcr217sTdXymzyJ2Xs34k28Lnqtto9,,4326970847,4326963449,-7398
4407,3332,2gLgfDKRhzMkDpCWk2us4LCebJ9HbiapfFjCTHQqxC9g,,84627398,84622398,-5000
4406,3331,BWCQUz43UZqzSb7ysUaWJRNPhMWL48KAM1R2E1xdf4Bw,,427805106,427799389,-5717
4405,3330,VUUXnZKyT1Zn2Tcr217sTdXymzyJ2Xs34k28Lnqtto9,,4326998224,4326970847,-27377
4404,3329,VUUXnZKyT1Zn2Tcr217sTdXymzyJ2Xs34k28Lnqtto9,,4325913458,4325908458,-5000
4403,3328,VUUXnZKyT1Zn2Tcr217sTdXymzyJ2Xs34k28Lnqtto9,,4325918458,4325913458,-5000
4402,3327,VUUXnZKyT1Zn2Tcr217sTdXymzyJ2Xs34k28Lnqtto9,,4325923458,4325918458,-5000
4401,3326,48vjRFEAAqqDLYEDVNSrghBcNVZZdFgcfWry9yqzKWQv,,0,1100000,1100000
4400,3326,VUUXnZKyT1Zn2Tcr217sTdXymzyJ2Xs34k28Lnqtto9,,4327028458,4325923458,-1105000
4399,3325,2gLgfDKRhzMkDpCWk2us4LCebJ9HbiapfFjCTHQqxC9g,,84632398,84627398,-5000
4398,3324,BWCQUz43UZqzSb7ysUaWJRNPhMWL48KAM1R2E1xdf4Bw,,427810981,427805106,-5875
4397,3323,VUUXnZKyT1Zn2Tcr217sTdXymzyJ2Xs34k28Lnqtto9,,4327055839,4327028458,-27381
4396,3322,VUUXnZKyT1Zn2Tcr217sTdXymzyJ2Xs34k28Lnqtto9,,4327063239,4327055839,-7400
4395,3321,2gLgfDKRhzMkDpCWk2us4LCebJ9HbiapfFjCTHQqxC9g,,84637398,84632398,-5000
4394,3320,BWCQUz43UZqzSb7ysUaWJRNPhMWL48KAM1R2E1xdf4Bw,,427816681,427810981,-5700
4393,3319,VUUXnZKyT1Zn2Tcr217sTdXymzyJ2Xs34k28Lnqtto9,,4327070639,4327063239,-7400
4392,3318,VUUXnZKyT1Zn2Tcr217sTdXymzyJ2Xs34k28Lnqtto9,,4325986351,4325981351,-5000
4391,3317,VUUXnZKyT1Zn2Tcr217sTdXymzyJ2Xs34k28Lnqtto9,,4325991351,4325986351,-5000
4390,3316,VUUXnZKyT1Zn2Tcr217sTdXymzyJ2Xs34k28Lnqtto9,,4325996351,4325991351,-5000
4389,3315,9hkMR1RtzecNieyKufdTvhFw7MYR4kJ7owKAy1cTbVe3,,0,1100000,1100000
4388,3315,VUUXnZKyT1Zn2Tcr217sTdXymzyJ2Xs34k28Lnqtto9,,4327101351,4325996351,-1105000
4387,3314,VUUXnZKyT1Zn2Tcr217sTdXymzyJ2Xs34k28Lnqtto9,,4327108750,4327101351,-7399
4386,3313,2gLgfDKRhzMkDpCWk2us4LCebJ9HbiapfFjCTHQqxC9g,,84642398,84637398,-5000
4385,3312,BWCQUz43UZqzSb7ysUaWJRNPhMWL48KAM1R2E1xdf4Bw,,427822389,427816681,-5708
4384,3311,VUUXnZKyT1Zn2Tcr217sTdXymzyJ2Xs34k28Lnqtto9,,4326024462,4326019462,-5000
4383,3310,VUUXnZKyT1Zn2Tcr217sTdXymzyJ2Xs34k28Lnqtto9,,4326029462,4326024462,-5000
4382,3309,VUUXnZKyT1Zn2Tcr217sTdXymzyJ2Xs34k28Lnqtto9,,4326034462,4326029462,-5000
4381,3308,4fS2abPiXy3Zi4Lnrmz65mQTY9GE3pnsxSXDfuM6Yjhm,,0,1100000,1100000
4380,3308,VUUXnZKyT1Zn2Tcr217sTdXymzyJ2Xs34k28Lnqtto9,,4327139462,4326034462,-1105000
4379,3307,VUUXnZKyT1Zn2Tcr217sTdXymzyJ2Xs34k28Lnqtto9,,4327146858,4327139462,-7396
4378,3306,2gLgfDKRhzMkDpCWk2us4LCebJ9HbiapfFjCTHQqxC9g,,84647398,84642398,-5000
4377,3305,BWCQUz43UZqzSb7ysUaWJRNPhMWL48KAM1R2E1xdf4Bw,,427828292,427822389,-5903
4376,3304,VUUXnZKyT1Zn2Tcr217sTdXymzyJ2Xs34k28Lnqtto9,,4327154258,4327146858,-7400
4375,3303,2gLgfDKRhzMkDpCWk2us4LCebJ9HbiapfFjCTHQqxC9g,,84652398,84647398,-5000
4374,3302,BWCQUz43UZqzSb7ysUaWJRNPhMWL48KAM1R2E1xdf4Bw,,427834228,427828292,-5936
4373,3301,VUUXnZKyT1Zn2Tcr217sTdXymzyJ2Xs34k28Lnqtto9,,4327161658,4327154258,-7400
4372,3300,2gLgfDKRhzMkDpCWk2us4LCebJ9HbiapfFjCTHQqxC9g,,84657398,84652398,-5000
4371,3299,BoYfJDbr5j8TYbr2w66DBNcXNhafHysbQngupVX4NArt,,235024239,235019239,-5000
4370,3298,VUUXnZKyT1Zn2Tcr217sTdXymzyJ2Xs34k28Lnqtto9,,4327169172,4327161658,-7514
4369,3297,BWCQUz43UZqzSb7ysUaWJRNPhMWL48KAM1R2E1xdf4Bw,,427840063,427834228,-5835
4368,3296,2gLgfDKRhzMkDpCWk2us4LCebJ9HbiapfFjCTHQqxC9g,,84662398,84657398,-5000
4367,3295,BWCQUz43UZqzSb7ysUaWJRNPhMWL48KAM1R2E1xdf4Bw,,427845787,427840063,-5724
4366,3294,VUUXnZKyT1Zn2Tcr217sTdXymzyJ2Xs34k28Lnqtto9,,4327176687,4327169172,-7515
4365,3293,VUUXnZKyT1Zn2Tcr217sTdXymzyJ2Xs34k28Lnqtto9,,4326092343,4326087343,-5000
4364,3292,VUUXnZKyT1Zn2Tcr217sTdXymzyJ2Xs34k28Lnqtto9,,4326097343,4326092343,-5000
4363,3291,VUUXnZKyT1Zn2Tcr217sTdXymzyJ2Xs34k28Lnqtto9,,4326102343,4326097343,-5000
4362,3290,F3XSqjgKCDAU9Jv4uFxkgi2mADQy1A3awqSp7b1Und8K,,0,1100000,1100000
4361,3290,VUUXnZKyT1Zn2Tcr217sTdXymzyJ2Xs34k28Lnqtto9,,4327207343,4326102343,-1105000
4360,3289,2gLgfDKRhzMkDpCWk2us4LCebJ9HbiapfFjCTHQqxC9g,,84667398,84662398,-5000
4359,3288,BWCQUz43UZqzSb7ysUaWJRNPhMWL48KAM1R2E1xdf4Bw,,427851757,427845787,-5970
4358,3287,VUUXnZKyT1Zn2Tcr217sTdXymzyJ2Xs34k28Lnqtto9,,4327214859,4327207343,-7516
4357,3286,2gLgfDKRhzMkDpCWk2us4LCebJ9HbiapfFjCTHQqxC9g,,84672398,84667398,-5000
4356,3285,BWCQUz43UZqzSb7ysUaWJRNPhMWL48KAM1R2E1xdf4Bw,,427857711,427851757,-5954
4355,3284,VUUXnZKyT1Zn2Tcr217sTdXymzyJ2Xs34k28Lnqtto9,,4327222376,4327214859,-7517
4354,3283,BWCQUz43UZqzSb7ysUaWJRNPhMWL48KAM1R2E1xdf4Bw,,432777471,432771623,-5848
4353,3282,VUUXnZKyT1Zn2Tcr217sTdXymzyJ2Xs34k28Lnqtto9,,4349258994,4349251596,-7398
4352,3281,A9eLa4Rr7Z78ovaiHQacsVsYRygtN32Pq48DhSLdhKoT,,740107541,740101805,-5736
4351,3280,2gLgfDKRhzMkDpCWk2us4LCebJ9HbiapfFjCTHQqxC9g,,88907398,88902398,-5000
4350,3279,2gLgfDKRhzMkDpCWk2us4LCebJ9HbiapfFjCTHQqxC9g,,88912398,88907398,-5000
4349,3278,BWCQUz43UZqzSb7ysUaWJRNPhMWL48KAM1R2E1xdf4Bw,,432783175,432777471,-5704
4348,3277,BWCQUz43UZqzSb7ysUaWJRNPhMWL48KAM1R2E1xdf4Bw,,432788935,432783175,-5760
4347,3276,A9eLa4Rr7Z78ovaiHQacsVsYRygtN32Pq48DhSLdhKoT,,740113051,740107541,-5510
4346,3275,A9eLa4Rr7Z78ovaiHQacsVsYRygtN32Pq48DhSLdhKoT,,740118969,740113051,-5918
4345,3274,VUUXnZKyT1Zn2Tcr217sTdXymzyJ2Xs34k28Lnqtto9,,4349266391,4349258994,-7397
4344,3273,VUUXnZKyT1Zn2Tcr217sTdXymzyJ2Xs34k28Lnqtto9,,4349273787,4349266391,-7396
4343,3272,A9eLa4Rr7Z78ovaiHQacsVsYRygtN32Pq48DhSLdhKoT,,740124789,740118969,-5820
4342,3271,2gLgfDKRhzMkDpCWk2us4LCebJ9HbiapfFjCTHQqxC9g,,88917398,88912398,-5000
4341,3270,2gLgfDKRhzMkDpCWk2us4LCebJ9HbiapfFjCTHQqxC9g,,88922398,88917398,-5000
4340,3269,BWCQUz43UZqzSb7ysUaWJRNPhMWL48KAM1R2E1xdf4Bw,,432794654,432788935,-5719
4339,3268,BWCQUz43UZqzSb7ysUaWJRNPhMWL48KAM1R2E1xdf4Bw,,432800373,432794654,-5719
4338,3267,A9eLa4Rr7Z78ovaiHQacsVsYRygtN32Pq48DhSLdhKoT,,740130265,740124789,-5476
4337,3266,A9eLa4Rr7Z78ovaiHQacsVsYRygtN32Pq48DhSLdhKoT,,740136206,740130265,-5941
4336,3265,VUUXnZKyT1Zn2Tcr217sTdXymzyJ2Xs34k28Lnqtto9,,4349281184,4349273787,-7397
4335,3264,A9eLa4Rr7Z78ovaiHQacsVsYRygtN32Pq48DhSLdhKoT,,740141930,740136206,-5724
4334,3263,BWCQUz43UZqzSb7ysUaWJRNPhMWL48KAM1R2E1xdf4Bw,,432806083,432800373,-5710
4333,3262,2gLgfDKRhzMkDpCWk2us4LCebJ9HbiapfFjCTHQqxC9g,,88927398,88922398,-5000
4332,3261,2gLgfDKRhzMkDpCWk2us4LCebJ9HbiapfFjCTHQqxC9g,,88932398,88927398,-5000
4331,3260,VUUXnZKyT1Zn2Tcr217sTdXymzyJ2Xs34k28Lnqtto9,,4349288585,4349281184,-7401
4330,3259,BWCQUz43UZqzSb7ysUaWJRNPhMWL48KAM1R2E1xdf4Bw,,432811825,432806083,-5742
4329,3258,A9eLa4Rr7Z78ovaiHQacsVsYRygtN32Pq48DhSLdhKoT,,740147598,740141930,-5668
4328,3257,VUUXnZKyT1Zn2Tcr217sTdXymzyJ2Xs34k28Lnqtto9,,4349295981,4349288585,-7396
4327,3256,VUUXnZKyT1Zn2Tcr217sTdXymzyJ2Xs34k28Lnqtto9,,4349303378,4349295981,-7397
4326,3255,A9eLa4Rr7Z78ovaiHQacsVsYRygtN32Pq48DhSLdhKoT,,740153537,740147598,-5939
4325,3254,BWCQUz43UZqzSb7ysUaWJRNPhMWL48KAM1R2E1xdf4Bw,,432817476,432811825,-5651
4324,3253,A9eLa4Rr7Z78ovaiHQacsVsYRygtN32Pq48DhSLdhKoT,,740159478,740153537,-5941
4323,3252,2gLgfDKRhzMkDpCWk2us4LCebJ9HbiapfFjCTHQqxC9g,,88937398,88932398,-5000
4322,3251,2gLgfDKRhzMkDpCWk2us4LCebJ9HbiapfFjCTHQqxC9g,,88942398,88937398,-5000
4321,3250,VUUXnZKyT1Zn2Tcr217sTdXymzyJ2Xs34k28Lnqtto9,,4349310774,4349303378,-7396
4320,3249,A9eLa4Rr7Z78ovaiHQacsVsYRygtN32Pq48DhSLdhKoT,,740164917,740159478,-5439
4319,3248,BWCQUz43UZqzSb7ysUaWJRNPhMWL48KAM1R2E1xdf4Bw,,432823462,432817476,-5986
4318,3247,A9eLa4Rr7Z78ovaiHQacsVsYRygtN32Pq48DhSLdhKoT,,740170724,740164917,-5807
4317,3246,VUUXnZKyT1Zn2Tcr217sTdXymzyJ2Xs34k28Lnqtto9,,9459832867,9459813090,-19777
4316,3245,VUUXnZKyT1Zn2Tcr217sTdXymzyJ2Xs34k28Lnqtto9,,9459852679,9459832867,-19812
4315,3244,VUUXnZKyT1Zn2Tcr217sTdXymzyJ2Xs34k28Lnqtto9,,9459872620,9459852679,-19941
4314,3243,9999kkxasWfVxfST4ha1arUuTcLFPRagpV3kdR9qpBEX,,296766980,296761237,-5743
4313,3242,VUUXnZKyT1Zn2Tcr217sTdXymzyJ2Xs34k28Lnqtto9,,9459892410,9459872620,-19790
4312,3241,DfXygSm4jCyNCybVYYK6DwvWqjKee8pbDmJGcLWNDXjh,,1296402,1298059,1657
4311,3241,EUDj8idRk3hwHvUV8M7LmPfvrCNADoMGDd7ZX4s38ntA,,233332393,233325736,-6657
4310,3240,ADaUMid9yfUytqMBgopwjb2DTLSokTSzL1zt6iGPaS49,,4758456,4760790,2334
4309,3240,EUDj8idRk3hwHvUV8M7LmPfvrCNADoMGDd7ZX4s38ntA,,233339727,233332393,-7334
4308,3239,DfXygSm4jCyNCybVYYK6DwvWqjKee8pbDmJGcLWNDXjh,,1293431,1296402,2971
4307,3239,EUDj8idRk3hwHvUV8M7LmPfvrCNADoMGDd7ZX4s38ntA,,233347698,233339727,-7971
4306,3238,96gYZGLnJYVFmbjzopPSU6QiEV5fGqZNyN9nmNhvrZU5,,8527532,8569183,41651
4305,3238,3KvsoNxgn64nsuHKPBHQJsguef3DgEkP2izE49k6CSAZ,,19405214922,19405168271,-46651
4304,3237,A9eLa4Rr7Z78ovaiHQacsVsYRygtN32Pq48DhSLdhKoT,,126626002,126620109,-5893
4303,3236,A9eLa4Rr7Z78ovaiHQacsVsYRygtN32Pq48DhSLdhKoT,,126631949,126626002,-5947
4302,3235,9999kkxasWfVxfST4ha1arUuTcLFPRagpV3kdR9qpBEX,,296860876,296855184,-5692
4301,3234,A9eLa4Rr7Z78ovaiHQacsVsYRygtN32Pq48DhSLdhKoT,,126637927,126631949,-5978
4300,3233,9999kkxasWfVxfST4ha1arUuTcLFPRagpV3kdR9qpBEX,,296866544,296860876,-5668
4299,3232,2nyhqdwKcJZR2vcqCyrYsaPVdAnFoJjiksCXJ7hfEYgD,,4695993525,4695998525,5000
4298,3232,8VS2f3f7CmiEDFDMqxAKgxCNhhZn7HkJLRDCWET2vXKv,,756818137,756807590,-10547
4297,3231,9999kkxasWfVxfST4ha1arUuTcLFPRagpV3kdR9qpBEX,,296872323,296866544,-5779
4296,3230,A9eLa4Rr7Z78ovaiHQacsVsYRygtN32Pq48DhSLdhKoT,,126645007,126637927,-7080
4295,3229,A9eLa4Rr7Z78ovaiHQacsVsYRygtN32Pq48DhSLdhKoT,,126652606,126645007,-7599
4294,3228,Cw8CFyM9FkoMi7K7Crf6HNQqf4uEMzpKw6QNghXLvLkY,,2060312,2091840,31528
4293,3228,3KvsoNxgn64nsuHKPBHQJsguef3DgEkP2izE49k6CSAZ,,19405251450,19405214922,-36528
4292,3227,HFqU5x63VTqvQss8hp11i4wVV8bD44PvwucfZ2bU7gRe,,2273594,2308221,34627
4291,3227,3KvsoNxgn64nsuHKPBHQJsguef3DgEkP2izE49k6CSAZ,,19405291077,19405251450,-39627
4290,3226,DfXygSm4jCyNCybVYYK6DwvWqjKee8pbDmJGcLWNDXjh,,1189923,1227690,37767
4289,3226,3KvsoNxgn64nsuHKPBHQJsguef3DgEkP2izE49k6CSAZ,,19405333844,19405291077,-42767
4288,3225,DfXygSm4jCyNCybVYYK6DwvWqjKee8pbDmJGcLWNDXjh,,1146159,1189923,43764
4287,3225,3KvsoNxgn64nsuHKPBHQJsguef3DgEkP2izE49k6CSAZ,,19405382608,19405333844,-48764
4286,3224,VUUXnZKyT1Zn2Tcr217sTdXymzyJ2Xs34k28Lnqtto9,,9459912241,9459892410,-19831
4285,3223,VUUXnZKyT1Zn2Tcr217sTdXymzyJ2Xs34k28Lnqtto9,,9459932030,9459912241,-19789
4284,3222,VUUXnZKyT1Zn2Tcr217sTdXymzyJ2Xs34k28Lnqtto9,,9459951819,9459932030,-19789
4283,3221,VUUXnZKyT1Zn2Tcr217sTdXymzyJ2Xs34k28Lnqtto9,,9459971591,9459951819,-19772
4282,3220,VUUXnZKyT1Zn2Tcr217sTdXymzyJ2Xs34k28Lnqtto9,,9459991419,9459971591,-19828
4281,3219,VUUXnZKyT1Zn2Tcr217sTdXymzyJ2Xs34k28Lnqtto9,,9460011239,9459991419,-19820
4280,3218,8VS2f3f7CmiEDFDMqxAKgxCNhhZn7HkJLRDCWET2vXKv,,756884865,756879865,-5000
4279,3217,8VS2f3f7CmiEDFDMqxAKgxCNhhZn7HkJLRDCWET2vXKv,,756889865,756884865,-5000
4278,3216,8VS2f3f7CmiEDFDMqxAKgxCNhhZn7HkJLRDCWET2vXKv,,756894865,756889865,-5000
4277,3215,4vieeGHPYPG2MmyPRcYjdiDmmhN3ww7hsFNap8pVN3Ey,,4295059875,4295064875,5000
4276,3215,8VS2f3f7CmiEDFDMqxAKgxCNhhZn7HkJLRDCWET2vXKv,,756905439,756894865,-10574
4275,3214,A9eLa4Rr7Z78ovaiHQacsVsYRygtN32Pq48DhSLdhKoT,,126660038,126652606,-7432
4274,3213,VUUXnZKyT1Zn2Tcr217sTdXymzyJ2Xs34k28Lnqtto9,,9460031024,9460011239,-19785
4273,3212,HFqU5x63VTqvQss8hp11i4wVV8bD44PvwucfZ2bU7gRe,,3631283,3670333,39050
4272,3212,3KvsoNxgn64nsuHKPBHQJsguef3DgEkP2izE49k6CSAZ,,19405426658,19405382608,-44050
4271,3211,A9eLa4Rr7Z78ovaiHQacsVsYRygtN32Pq48DhSLdhKoT,,126665458,126660038,-5420
4270,3210,VUUXnZKyT1Zn2Tcr217sTdXymzyJ2Xs34k28Lnqtto9,,9460050830,9460031024,-19806
4269,3209,A9eLa4Rr7Z78ovaiHQacsVsYRygtN32Pq48DhSLdhKoT,,126671229,126665458,-5771
4268,3208,VUUXnZKyT1Zn2Tcr217sTdXymzyJ2Xs34k28Lnqtto9,,9460070642,9460050830,-19812
4267,3207,8VS2f3f7CmiEDFDMqxAKgxCNhhZn7HkJLRDCWET2vXKv,,756917275,756912275,-5000
4266,3206,Ek23iWDACc56FsG4nLM936xPUXs9HskjXPKuvHzX99Wg,,432498417,432492859,-5558
4265,3205,9999kkxasWfVxfST4ha1arUuTcLFPRagpV3kdR9qpBEX,,296904439,296898741,-5698
4264,3204,8VS2f3f7CmiEDFDMqxAKgxCNhhZn7HkJLRDCWET2vXKv,,756922275,756917275,-5000
4263,3203,8VS2f3f7CmiEDFDMqxAKgxCNhhZn7HkJLRDCWET2vXKv,,756927275,756922275,-5000
4262,3202,8VS2f3f7CmiEDFDMqxAKgxCNhhZn7HkJLRDCWET2vXKv,,756932275,756927275,-5000
4261,3201,4TQLFNWK8AovT1gFvda5jfw2oJeRMKEmw7aH6MGBJ3or,,4969471369,4969476369,5000
4260,3201,8VS2f3f7CmiEDFDMqxAKgxCNhhZn7HkJLRDCWET2vXKv,,756942847,756932275,-10572
4259,3200,ADaUMid9yfUytqMBgopwjb2DTLSokTSzL1zt6iGPaS49,,1015874,1054150,38276
4258,3200,3KvsoNxgn64nsuHKPBHQJsguef3DgEkP2izE49k6CSAZ,,19405469934,19405426658,-43276
4257,3199,A9eLa4Rr7Z78ovaiHQacsVsYRygtN32Pq48DhSLdhKoT,,126676897,126671229,-5668
4256,3198,VUUXnZKyT1Zn2Tcr217sTdXymzyJ2Xs34k28Lnqtto9,,9460090441,9460070642,-19799
4255,3197,A9eLa4Rr7Z78ovaiHQacsVsYRygtN32Pq48DhSLdhKoT,,126682791,126676897,-5894
4254,3196,8VS2f3f7CmiEDFDMqxAKgxCNhhZn7HkJLRDCWET2vXKv,,756963344,756958344,-5000
4253,3195,8VS2f3f7CmiEDFDMqxAKgxCNhhZn7HkJLRDCWET2vXKv,,756968344,756963344,-5000
4252,3194,8VS2f3f7CmiEDFDMqxAKgxCNhhZn7HkJLRDCWET2vXKv,,756973344,756968344,-5000
4251,3193,8VS2f3f7CmiEDFDMqxAKgxCNhhZn7HkJLRDCWET2vXKv,,756978344,756973344,-5000
4250,3192,8VS2f3f7CmiEDFDMqxAKgxCNhhZn7HkJLRDCWET2vXKv,,756983344,756978344,-5000
4249,3191,8VS2f3f7CmiEDFDMqxAKgxCNhhZn7HkJLRDCWET2vXKv,,756988344,756983344,-5000
4248,3190,8VS2f3f7CmiEDFDMqxAKgxCNhhZn7HkJLRDCWET2vXKv,,756993344,756988344,-5000
4247,3189,8VS2f3f7CmiEDFDMqxAKgxCNhhZn7HkJLRDCWET2vXKv,,756998344,756993344,-5000
4246,3188,A9eLa4Rr7Z78ovaiHQacsVsYRygtN32Pq48DhSLdhKoT,,126688274,126682791,-5483
4245,3187,Ek23iWDACc56FsG4nLM936xPUXs9HskjXPKuvHzX99Wg,,432504036,432498417,-5619
4244,3186,A9eLa4Rr7Z78ovaiHQacsVsYRygtN32Pq48DhSLdhKoT,,126694024,126688274,-5750
4243,3185,A9eLa4Rr7Z78ovaiHQacsVsYRygtN32Pq48DhSLdhKoT,,126699778,126694024,-5754
4242,3184,A9eLa4Rr7Z78ovaiHQacsVsYRygtN32Pq48DhSLdhKoT,,126705398,126699778,-5620
4241,3183,Ek23iWDACc56FsG4nLM936xPUXs9HskjXPKuvHzX99Wg,,432509724,432504036,-5688
4240,3182,4vieeGHPYPG2MmyPRcYjdiDmmhN3ww7hsFNap8pVN3Ey,,4295054875,4295059875,5000
4239,3182,8VS2f3f7CmiEDFDMqxAKgxCNhhZn7HkJLRDCWET2vXKv,,757008769,756998344,-10425
4238,3181,9999kkxasWfVxfST4ha1arUuTcLFPRagpV3kdR9qpBEX,,296910086,296904439,-5647
4237,3180,9999kkxasWfVxfST4ha1arUuTcLFPRagpV3kdR9qpBEX,,296915829,296910086,-5743
4236,3179,2q5pghRs6arqVjRvT5gfgWfWcHWmw1ZuCzphgd5KfWGJ,,4153814738,4153819738,5000
4235,3179,8VS2f3f7CmiEDFDMqxAKgxCNhhZn7HkJLRDCWET2vXKv,,757019337,757008769,-10568
4234,3178,Cw8CFyM9FkoMi7K7Crf6HNQqf4uEMzpKw6QNghXLvLkY,,1030194,1068600,38406
4233,3178,3KvsoNxgn64nsuHKPBHQJsguef3DgEkP2izE49k6CSAZ,,19405513340,19405469934,-43406
4232,3177,A9eLa4Rr7Z78ovaiHQacsVsYRygtN32Pq48DhSLdhKoT,,126713265,126705398,-7867
4231,3176,VUUXnZKyT1Zn2Tcr217sTdXymzyJ2Xs34k28Lnqtto9,,9460110271,9460090441,-19830
4230,3175,VUUXnZKyT1Zn2Tcr217sTdXymzyJ2Xs34k28Lnqtto9,,9460130018,9460110271,-19747
4229,3174,Cw8CFyM9FkoMi7K7Crf6HNQqf4uEMzpKw6QNghXLvLkY,,946560,987228,40668
4228,3174,3KvsoNxgn64nsuHKPBHQJsguef3DgEkP2izE49k6CSAZ,,19405559008,19405513340,-45668
4227,3173,A9eLa4Rr7Z78ovaiHQacsVsYRygtN32Pq48DhSLdhKoT,,126720948,126713265,-7683
4226,3172,A9eLa4Rr7Z78ovaiHQacsVsYRygtN32Pq48DhSLdhKoT,,126726345,126720948,-5397
4225,3171,A9eLa4Rr7Z78ovaiHQacsVsYRygtN32Pq48DhSLdhKoT,,126731897,126726345,-5552
4224,3170,Ek23iWDACc56FsG4nLM936xPUXs9HskjXPKuvHzX99Wg,,432515677,432509724,-5953
4223,3169,9999kkxasWfVxfST4ha1arUuTcLFPRagpV3kdR9qpBEX,,296962860,296957096,-5764
4222,3168,VUUXnZKyT1Zn2Tcr217sTdXymzyJ2Xs34k28Lnqtto9,,9460149564,9460130018,-19546
4221,3167,VUUXnZKyT1Zn2Tcr217sTdXymzyJ2Xs34k28Lnqtto9,,9460169320,9460149564,-19756
4220,3166,VUUXnZKyT1Zn2Tcr217sTdXymzyJ2Xs34k28Lnqtto9,,9460189123,9460169320,-19803
4219,3165,VUUXnZKyT1Zn2Tcr217sTdXymzyJ2Xs34k28Lnqtto9,,9460209127,9460189123,-20004
4218,3164,VUUXnZKyT1Zn2Tcr217sTdXymzyJ2Xs34k28Lnqtto9,,9460229107,9460209127,-19980
4217,3163,VUUXnZKyT1Zn2Tcr217sTdXymzyJ2Xs34k28Lnqtto9,,9460249087,9460229107,-19980
4216,3162,DfXygSm4jCyNCybVYYK6DwvWqjKee8pbDmJGcLWNDXjh,,1079673,1115843,36170
4215,3162,3KvsoNxgn64nsuHKPBHQJsguef3DgEkP2izE49k6CSAZ,,19405600178,19405559008,-41170
4214,3161,DttWaMuVvTiduZRnguLF7jNxTgiMBZ1hyAumKUiL2KRL,,13989486,14024012,34526
4213,3161,3KvsoNxgn64nsuHKPBHQJsguef3DgEkP2izE49k6CSAZ,,19405639704,19405600178,-39526
4212,3160,77777T2qnynHFsA63FyfY766ciBTXizavU1f5HeZXwN,,4733460250,4733454707,-5543
4211,3159,8VS2f3f7CmiEDFDMqxAKgxCNhhZn7HkJLRDCWET2vXKv,,757084437,757079437,-5000
4210,3158,8VS2f3f7CmiEDFDMqxAKgxCNhhZn7HkJLRDCWET2vXKv,,757089437,757084437,-5000
4209,3157,8VS2f3f7CmiEDFDMqxAKgxCNhhZn7HkJLRDCWET2vXKv,,757094437,757089437,-5000
4208,3156,8VS2f3f7CmiEDFDMqxAKgxCNhhZn7HkJLRDCWET2vXKv,,757099437,757094437,-5000
4207,3155,8VS2f3f7CmiEDFDMqxAKgxCNhhZn7HkJLRDCWET2vXKv,,757104437,757099437,-5000
4206,3154,8VS2f3f7CmiEDFDMqxAKgxCNhhZn7HkJLRDCWET2vXKv,,757109437,757104437,-5000
4205,3153,8VS2f3f7CmiEDFDMqxAKgxCNhhZn7HkJLRDCWET2vXKv,,757114437,757109437,-5000
4204,3152,8VS2f3f7CmiEDFDMqxAKgxCNhhZn7HkJLRDCWET2vXKv,,757119437,757114437,-5000
4203,3151,8VS2f3f7CmiEDFDMqxAKgxCNhhZn7HkJLRDCWET2vXKv,,757124437,757119437,-5000
4202,3150,8VS2f3f7CmiEDFDMqxAKgxCNhhZn7HkJLRDCWET2vXKv,,757129437,757124437,-5000
4201,3149,8VS2f3f7CmiEDFDMqxAKgxCNhhZn7HkJLRDCWET2vXKv,,757134437,757129437,-5000
4200,3148,8VS2f3f7CmiEDFDMqxAKgxCNhhZn7HkJLRDCWET2vXKv,,757139437,757134437,-5000
4199,3147,8VS2f3f7CmiEDFDMqxAKgxCNhhZn7HkJLRDCWET2vXKv,,757144437,757139437,-5000
4198,3146,8VS2f3f7CmiEDFDMqxAKgxCNhhZn7HkJLRDCWET2vXKv,,757149437,757144437,-5000
4197,3145,8VS2f3f7CmiEDFDMqxAKgxCNhhZn7HkJLRDCWET2vXKv,,757154437,757149437,-5000
4196,3144,8VS2f3f7CmiEDFDMqxAKgxCNhhZn7HkJLRDCWET2vXKv,,757159437,757154437,-5000
4195,3143,8VS2f3f7CmiEDFDMqxAKgxCNhhZn7HkJLRDCWET2vXKv,,757164437,757159437,-5000
4194,3142,8VS2f3f7CmiEDFDMqxAKgxCNhhZn7HkJLRDCWET2vXKv,,757169437,757164437,-5000
4193,3141,8VS2f3f7CmiEDFDMqxAKgxCNhhZn7HkJLRDCWET2vXKv,,757174437,757169437,-5000
4192,3140,8VS2f3f7CmiEDFDMqxAKgxCNhhZn7HkJLRDCWET2vXKv,,757179437,757174437,-5000
4191,3139,8VS2f3f7CmiEDFDMqxAKgxCNhhZn7HkJLRDCWET2vXKv,,757184437,757179437,-5000
4190,3138,8VS2f3f7CmiEDFDMqxAKgxCNhhZn7HkJLRDCWET2vXKv,,757189437,757184437,-5000
4189,3137,8VS2f3f7CmiEDFDMqxAKgxCNhhZn7HkJLRDCWET2vXKv,,757194437,757189437,-5000
4188,3136,8VS2f3f7CmiEDFDMqxAKgxCNhhZn7HkJLRDCWET2vXKv,,757199437,757194437,-5000
4187,3135,8VS2f3f7CmiEDFDMqxAKgxCNhhZn7HkJLRDCWET2vXKv,,757204437,757199437,-5000
4186,3134,8VS2f3f7CmiEDFDMqxAKgxCNhhZn7HkJLRDCWET2vXKv,,757209437,757204437,-5000
4185,3133,8VS2f3f7CmiEDFDMqxAKgxCNhhZn7HkJLRDCWET2vXKv,,757214437,757209437,-5000
4184,3132,8VS2f3f7CmiEDFDMqxAKgxCNhhZn7HkJLRDCWET2vXKv,,757219437,757214437,-5000
4183,3131,8VS2f3f7CmiEDFDMqxAKgxCNhhZn7HkJLRDCWET2vXKv,,757224437,757219437,-5000
4182,3130,8VS2f3f7CmiEDFDMqxAKgxCNhhZn7HkJLRDCWET2vXKv,,757229437,757224437,-5000
4181,3129,8VS2f3f7CmiEDFDMqxAKgxCNhhZn7HkJLRDCWET2vXKv,,757234437,757229437,-5000
4180,3128,8VS2f3f7CmiEDFDMqxAKgxCNhhZn7HkJLRDCWET2vXKv,,757239437,757234437,-5000
4179,3127,Ek23iWDACc56FsG4nLM936xPUXs9HskjXPKuvHzX99Wg,,432521257,432515677,-5580
4178,3126,A9eLa4Rr7Z78ovaiHQacsVsYRygtN32Pq48DhSLdhKoT,,126737734,126731897,-5837
4177,3125,9bnz4RShgq1hAnLnZbP8kbgBg1kEmcJBYQq3gQbmnSta,,4138542310,4138547310,5000
4176,3125,8VS2f3f7CmiEDFDMqxAKgxCNhhZn7HkJLRDCWET2vXKv,,757249858,757239437,-10421
4175,3124,A9eLa4Rr7Z78ovaiHQacsVsYRygtN32Pq48DhSLdhKoT,,126743677,126737734,-5943
4174,3123,9999kkxasWfVxfST4ha1arUuTcLFPRagpV3kdR9qpBEX,,296982330,296976561,-5769
4173,3122,A9eLa4Rr7Z78ovaiHQacsVsYRygtN32Pq48DhSLdhKoT,,126751055,126743677,-7378
4172,3121,HFqU5x63VTqvQss8hp11i4wVV8bD44PvwucfZ2bU7gRe,,1054195,1087704,33509
4171,3121,3KvsoNxgn64nsuHKPBHQJsguef3DgEkP2izE49k6CSAZ,,19405678213,19405639704,-38509
4170,3120,8VS2f3f7CmiEDFDMqxAKgxCNhhZn7HkJLRDCWET2vXKv,,757260914,757255914,-5000
4169,3119,8VS2f3f7CmiEDFDMqxAKgxCNhhZn7HkJLRDCWET2vXKv,,757265914,757260914,-5000
4168,3118,8VS2f3f7CmiEDFDMqxAKgxCNhhZn7HkJLRDCWET2vXKv,,757270914,757265914,-5000
4167,3117,8VS2f3f7CmiEDFDMqxAKgxCNhhZn7HkJLRDCWET2vXKv,,757275914,757270914,-5000
4166,3116,A9eLa4Rr7Z78ovaiHQacsVsYRygtN32Pq48DhSLdhKoT,,126756550,126751055,-5495
4165,3115,A9eLa4Rr7Z78ovaiHQacsVsYRygtN32Pq48DhSLdhKoT,,126762058,126756550,-5508
4164,3114,A9eLa4Rr7Z78ovaiHQacsVsYRygtN32Pq48DhSLdhKoT,,126767619,126762058,-5561
4163,3113,A9eLa4Rr7Z78ovaiHQacsVsYRygtN32Pq48DhSLdhKoT,,126773174,126767619,-5555
4162,3112,A9eLa4Rr7Z78ovaiHQacsVsYRygtN32Pq48DhSLdhKoT,,126778743,126773174,-5569
4161,3111,Ek23iWDACc56FsG4nLM936xPUXs9HskjXPKuvHzX99Wg,,432526913,432521257,-5656
4160,3110,Ek23iWDACc56FsG4nLM936xPUXs9HskjXPKuvHzX99Wg,,432532635,432526913,-5722
4159,3109,A9eLa4Rr7Z78ovaiHQacsVsYRygtN32Pq48DhSLdhKoT,,126784446,126778743,-5703
4158,3108,Ek23iWDACc56FsG4nLM936xPUXs9HskjXPKuvHzX99Wg,,432538382,432532635,-5747
4157,3107,A9eLa4Rr7Z78ovaiHQacsVsYRygtN32Pq48DhSLdhKoT,,126790123,126784446,-5677
4156,3106,A9eLa4Rr7Z78ovaiHQacsVsYRygtN32Pq48DhSLdhKoT,,126795804,126790123,-5681
4155,3105,A9eLa4Rr7Z78ovaiHQacsVsYRygtN32Pq48DhSLdhKoT,,126801519,126795804,-5715
4154,3104,VUUXnZKyT1Zn2Tcr217sTdXymzyJ2Xs34k28Lnqtto9,,9460268632,9460249087,-19545
4153,3103,VUUXnZKyT1Zn2Tcr217sTdXymzyJ2Xs34k28Lnqtto9,,9460288170,9460268632,-19538
4152,3102,77777T2qnynHFsA63FyfY766ciBTXizavU1f5HeZXwN,,4733466933,4733460250,-6683
4151,3101,A9eLa4Rr7Z78ovaiHQacsVsYRygtN32Pq48DhSLdhKoT,,126807275,126801519,-5756
4150,3100,A9eLa4Rr7Z78ovaiHQacsVsYRygtN32Pq48DhSLdhKoT,,126813060,126807275,-5785
4149,3099,Ek23iWDACc56FsG4nLM936xPUXs9HskjXPKuvHzX99Wg,,432544302,432538382,-5920
4148,3098,A9eLa4Rr7Z78ovaiHQacsVsYRygtN32Pq48DhSLdhKoT,,126818922,126813060,-5862
4147,3097,A9eLa4Rr7Z78ovaiHQacsVsYRygtN32Pq48DhSLdhKoT,,126824781,126818922,-5859
4146,3096,A9eLa4Rr7Z78ovaiHQacsVsYRygtN32Pq48DhSLdhKoT,,126830576,126824781,-5795
4145,3095,3KCKozbAaF75qEU33jtzozcJ29yJuaLJTy2jFdzUY8bT,,4864004607,4864009607,5000
4144,3095,8VS2f3f7CmiEDFDMqxAKgxCNhhZn7HkJLRDCWET2vXKv,,757286251,757275914,-10337
4143,3094,Ek23iWDACc56FsG4nLM936xPUXs9HskjXPKuvHzX99Wg,,432550199,432544302,-5897
4142,3093,3KCKozbAaF75qEU33jtzozcJ29yJuaLJTy2jFdzUY8bT,,4863999607,4864004607,5000
4141,3093,8VS2f3f7CmiEDFDMqxAKgxCNhhZn7HkJLRDCWET2vXKv,,757296664,757286251,-10413
4140,3092,A9eLa4Rr7Z78ovaiHQacsVsYRygtN32Pq48DhSLdhKoT,,126836393,126830576,-5817
4139,3091,5VY91ws6B2hMmBFRsXkoAAdsPHBJwRfBht4DXox3xkwn,,4500601557,4500606557,5000
4138,3091,8VS2f3f7CmiEDFDMqxAKgxCNhhZn7HkJLRDCWET2vXKv,,757307037,757296664,-10373
4137,3090,A9eLa4Rr7Z78ovaiHQacsVsYRygtN32Pq48DhSLdhKoT,,126842292,126836393,-5899
4136,3089,9bnz4RShgq1hAnLnZbP8kbgBg1kEmcJBYQq3gQbmnSta,,4138537310,4138542310,5000
4135,3089,8VS2f3f7CmiEDFDMqxAKgxCNhhZn7HkJLRDCWET2vXKv,,757317546,757307037,-10509
4134,3088,9999kkxasWfVxfST4ha1arUuTcLFPRagpV3kdR9qpBEX,,297000869,296995071,-5798
4133,3087,A9eLa4Rr7Z78ovaiHQacsVsYRygtN32Pq48DhSLdhKoT,,126847905,126842292,-5613
4132,3086,Ek23iWDACc56FsG4nLM936xPUXs9HskjXPKuvHzX99Wg,,432555874,432550199,-5675
4131,3085,A9eLa4Rr7Z78ovaiHQacsVsYRygtN32Pq48DhSLdhKoT,,126853850,126847905,-5945
4130,3084,9bnz4RShgq1hAnLnZbP8kbgBg1kEmcJBYQq3gQbmnSta,,4138532310,4138537310,5000
4129,3084,8VS2f3f7CmiEDFDMqxAKgxCNhhZn7HkJLRDCWET2vXKv,,757328075,757317546,-10529
4128,3083,9999kkxasWfVxfST4ha1arUuTcLFPRagpV3kdR9qpBEX,,297021211,297015562,-5649
4127,3082,9999kkxasWfVxfST4ha1arUuTcLFPRagpV3kdR9qpBEX,,297026862,297021211,-5651
4126,3081,4TQLFNWK8AovT1gFvda5jfw2oJeRMKEmw7aH6MGBJ3or,,4969466369,4969471369,5000
4125,3081,8VS2f3f7CmiEDFDMqxAKgxCNhhZn7HkJLRDCWET2vXKv,,757338633,757328075,-10558
4124,3080,3KCKozbAaF75qEU33jtzozcJ29yJuaLJTy2jFdzUY8bT,,4863994607,4863999607,5000
4123,3080,8VS2f3f7CmiEDFDMqxAKgxCNhhZn7HkJLRDCWET2vXKv,,757349156,757338633,-10523
4122,3079,9999kkxasWfVxfST4ha1arUuTcLFPRagpV3kdR9qpBEX,,297032563,297026862,-5701
4121,3078,9999kkxasWfVxfST4ha1arUuTcLFPRagpV3kdR9qpBEX,,297038307,297032563,-5744
4120,3077,A9eLa4Rr7Z78ovaiHQacsVsYRygtN32Pq48DhSLdhKoT,,126859909,126853850,-6059
4119,3076,ADuUkR4vqLUMWXxW9gh6D6L8pMSawimctcNZ5pGwDcEt,,951585,993757,42172
4118,3076,3KvsoNxgn64nsuHKPBHQJsguef3DgEkP2izE49k6CSAZ,,19405725385,19405678213,-47172
4117,3075,A9eLa4Rr7Z78ovaiHQacsVsYRygtN32Pq48DhSLdhKoT,,126867338,126859909,-7429
4116,3074,A9eLa4Rr7Z78ovaiHQacsVsYRygtN32Pq48DhSLdhKoT,,126874989,126867338,-7651
4115,3073,Cw8CFyM9FkoMi7K7Crf6HNQqf4uEMzpKw6QNghXLvLkY,,946560,981280,34720
4114,3073,3KvsoNxgn64nsuHKPBHQJsguef3DgEkP2izE49k6CSAZ,,19405765105,19405725385,-39720
4113,3072,VUUXnZKyT1Zn2Tcr217sTdXymzyJ2Xs34k28Lnqtto9,,9460307884,9460288170,-19714
4112,3071,VUUXnZKyT1Zn2Tcr217sTdXymzyJ2Xs34k28Lnqtto9,,9460327737,9460307884,-19853
4111,3070,VUUXnZKyT1Zn2Tcr217sTdXymzyJ2Xs34k28Lnqtto9,,9460347578,9460327737,-19841
4110,3069,VUUXnZKyT1Zn2Tcr217sTdXymzyJ2Xs34k28Lnqtto9,,9460367488,9460347578,-19910
4109,3068,VUUXnZKyT1Zn2Tcr217sTdXymzyJ2Xs34k28Lnqtto9,,9460387388,9460367488,-19900
4108,3067,HFqU5x63VTqvQss8hp11i4wVV8bD44PvwucfZ2bU7gRe,,6102070,6144863,42793
4107,3067,3KvsoNxgn64nsuHKPBHQJsguef3DgEkP2izE49k6CSAZ,,19405812898,19405765105,-47793
4106,3066,DfXygSm4jCyNCybVYYK6DwvWqjKee8pbDmJGcLWNDXjh,,6259503,6300013,40510
4105,3066,3KvsoNxgn64nsuHKPBHQJsguef3DgEkP2izE49k6CSAZ,,19405858408,19405812898,-45510
4104,3065,A9eLa4Rr7Z78ovaiHQacsVsYRygtN32Pq48DhSLdhKoT,,126881943,126874989,-6954
4103,3064,VUUXnZKyT1Zn2Tcr217sTdXymzyJ2Xs34k28Lnqtto9,,9460406946,9460387388,-19558
4102,3063,VUUXnZKyT1Zn2Tcr217sTdXymzyJ2Xs34k28Lnqtto9,,9460426480,9460406946,-19534
4101,3062,VUUXnZKyT1Zn2Tcr217sTdXymzyJ2Xs34k28Lnqtto9,,9460446199,9460426480,-19719
4100,3061,3AVi9Tg9Uo68tJfuvoKvqKNWKkC5wPdSSdeBnizKZ6jT,,3105516,3143583,38067
4099,3061,3KvsoNxgn64nsuHKPBHQJsguef3DgEkP2izE49k6CSAZ,,19405901475,19405858408,-43067
4098,3060,DttWaMuVvTiduZRnguLF7jNxTgiMBZ1hyAumKUiL2KRL,,1099291,1142380,43089
4097,3060,3KvsoNxgn64nsuHKPBHQJsguef3DgEkP2izE49k6CSAZ,,19405949564,19405901475,-48089
4096,3059,Ek23iWDACc56FsG4nLM936xPUXs9HskjXPKuvHzX99Wg,,432561929,432555874,-6055
4095,3058,3KCKozbAaF75qEU33jtzozcJ29yJuaLJTy2jFdzUY8bT,,4863989607,4863994607,5000
4094,3058,8VS2f3f7CmiEDFDMqxAKgxCNhhZn7HkJLRDCWET2vXKv,,757416992,757406455,-10537
4093,3057,9999kkxasWfVxfST4ha1arUuTcLFPRagpV3kdR9qpBEX,,297124130,297118354,-5776
4092,3056,9999kkxasWfVxfST4ha1arUuTcLFPRagpV3kdR9qpBEX,,297129889,297124130,-5759
4091,3055,VUUXnZKyT1Zn2Tcr217sTdXymzyJ2Xs34k28Lnqtto9,,9460465732,9460446199,-19533
4090,3054,VUUXnZKyT1Zn2Tcr217sTdXymzyJ2Xs34k28Lnqtto9,,9460485449,9460465732,-19717
4089,3053,VUUXnZKyT1Zn2Tcr217sTdXymzyJ2Xs34k28Lnqtto9,,9460505178,9460485449,-19729
4088,3052,DfXygSm4jCyNCybVYYK6DwvWqjKee8pbDmJGcLWNDXjh,,1169586,1170633,1047
4087,3052,77777T2qnynHFsA63FyfY766ciBTXizavU1f5HeZXwN,,4733472980,4733466933,-6047
4086,3051,Cw8CFyM9FkoMi7K7Crf6HNQqf4uEMzpKw6QNghXLvLkY,,2177543,2220597,43054
4085,3051,3KvsoNxgn64nsuHKPBHQJsguef3DgEkP2izE49k6CSAZ,,19405997618,19405949564,-48054
4084,3050,DfXygSm4jCyNCybVYYK6DwvWqjKee8pbDmJGcLWNDXjh,,1023057,1065891,42834
4083,3050,3KvsoNxgn64nsuHKPBHQJsguef3DgEkP2izE49k6CSAZ,,19406045452,19405997618,-47834
4082,3049,3AVi9Tg9Uo68tJfuvoKvqKNWKkC5wPdSSdeBnizKZ6jT,,1989577,2022632,33055
4081,3049,3KvsoNxgn64nsuHKPBHQJsguef3DgEkP2izE49k6CSAZ,,19406083507,19406045452,-38055
4080,3048,A9eLa4Rr7Z78ovaiHQacsVsYRygtN32Pq48DhSLdhKoT,,126888999,126881943,-7056
4079,3047,VUUXnZKyT1Zn2Tcr217sTdXymzyJ2Xs34k28Lnqtto9,,9460524726,9460505178,-19548
4078,3046,VUUXnZKyT1Zn2Tcr217sTdXymzyJ2Xs34k28Lnqtto9,,9460544270,9460524726,-19544
4077,3045,VUUXnZKyT1Zn2Tcr217sTdXymzyJ2Xs34k28Lnqtto9,,9460563989,9460544270,-19719
4076,3044,VUUXnZKyT1Zn2Tcr217sTdXymzyJ2Xs34k28Lnqtto9,,9460583701,9460563989,-19712
4075,3043,DttWaMuVvTiduZRnguLF7jNxTgiMBZ1hyAumKUiL2KRL,,988182,989819,1637
